# Menu
User = Usuario
Join... = Únete...
Login... = Acceso...
Log in = Acceso
Logout = Desconectar
Change password... = Cambiar contraseña
User Preference = Preferencias de usuario
System Settings... = Ajustes de Sistema...
System Settings = Ajustes de Sistema
Crash = Fallo
Invite friends... = Invitar amigos
Language = Idioma
Language Setting = Configuración de idioma

Document Recovery = Recuperar documento
Your Preferences Information = Información sobre tus preferencias
File = Archivo
New = Nuevo
Project... = Proyecto...
Schematic = Esquemático
Schematic-Simulation = Simulación del esquemático
Spice Symbol = Símbolo Spice
Spice Subckt = Subckt Spice
spicePre = spicePre
PCB = PCB
Schematic Module = Módulo Esquemático
PCB Module = Módulo PCB
Save... = Guardar...
Save As... = Guardar como...
Save As Module... = Guardar como Módulo...
Print = Imprimir
Export Document = Exportar Documento
LTspice... = LTspice...
Eagle... = Eagle...
Altium... = Altium..
Cadence... = Cadence...
Pads... = Pads...
DXF = DXF
Import = Importar

Edit = Editar
Undo = Deshacer
Redo = Rehacer
Cut = Cortar
Copy = Copiar
Paste = Pegar
Select = Seleccionar
Delete = Eliminar
Clear All = Limpiar Todo
Move = Mover
Drag = Arrastrar
Bring to Front = Traer al Frente
Send to Back = Enviar al Fondo
Align = Alinear
Align Left = Alineación Izquierda
Align Right = Alineación Derecha
Align Top = Alineación Superior
Align Bottom = Alineación Inferior
Align Horizontal Centers = Alinear al centro Horizontal
Align Vertical Centers = Alinear al centro Vertical
Distribute Horizontally = Distribuir Horizontalmente
Distribute Vertically = Distribuir Verticalmente
Distribute Left Edges Equidistantly = Distribuir Esquinas Derechas Equidistantemente
Distribute Top Edges Equidistantly = Distribuir Esquinas Superiores Equidistantemente
Align Grid = Alinear Rejilla
Rotate = Rotar
Rotate Left = Rotar hacia la Izquierda
Rotate Right = Rotar hacia la Derecha
Flip Horizontal = Voltear Horizontalmente
Flip Vertical = Voltear Verticalmente
Rotate and Flip = Rotar y Voltear
Group/Ungroup Symbol... = Símbolo Agrupar/Desagrupar...

[menu_project]
View = Ver
[/menu_project]
Find = Buscar
Zoom In = Acercar
Zoom Out = Alejar
Fit in Window = Ajustar a la pantalla
Refresh = Refrescar
Snap = Captura
Cross Cursor = Cursor Cruzado
Toolbars = Barras de herramientas
Drawing Tools = Herramientas de Dibujo
Wiring Tools = Herramientas de Cableado
Power Objects = Objetos de Potencia
PCB Tools = Herramientas PCB
Footprint Tools = Herramientas de Huella
Layers Tool = Herramientas de Capa
Layer Manager = Administrador de C1apa
Enable and Show All Layers = Activar y Ver Todas las Capas
Net Visible = Red visible
Auto = Auto
Digital Objects = Objetos Digitales
Tools = Herramientas
Arc Center = Centro del Arco
Arc Type = Tipo de arco
Center Point Arc = Arco con Punto central
Two-point Arc = Arco con Dos Puntos

Place = Ubicar
Drawing Tools = Herramientas de Dibujo
Arc = Arco
Elliptical Arc = Arco elíptico
Ellipse = Elipse
Circle = Círculo
Pie = Tarta
Line = Línea
Polyline = Polilínea
Rectangle = Rectángulo
Rectangular = Rectangular
The rectangle does not support non-90 degree rotation. Please use Solid Region instead. = El rectángulo no soporta rotación distinta a 90 grados. En su lugar, por favor usar Región Sólida.

Rect = Recta
Round Rectangle = Rectángulo redondeado
Polygon = Polígono
Bezier = Bezier
Path = Ruta
Graphic = Gráfico
Bus = Bus
Bus Entry = Entrada Bus
Junction = Junta
Net Port = Puerto de Red
Voltage Probe = Sonda de voltaje
Power Port = Puerto de potencia
Wire = Cable
Annotation = Anotación
Track = Pista
Image = Imagen
Arrow Head = Cabeza Flecha
Arrowhead =
Arrow = Flecha
No Connect Flag = Bandera de No Conectado
Place = Ubicar
Pin = Pin
Lock Selected Objects = Bloquear Objetos Seleccionados

Miscellaneous = Misceláneo
Find Component = Encontrar componente
Component = Componente
Footprint... = Huella...
This component is deleted! = ¡Este componente se ha borrado!
Convert = Convertir
Convert Schematic to PCB = Convertir esquemático a PCB
The component ID will be reset according to the component prefix, this operation will clear Undo histories. Please notice: = El componente ID será restablecido según el prefijo del componente, esta operación borrará el historial de deshacer. Note por favor:
Please make sure the component prefixes of the schematic and PCB are corresponding = Por favor asegurarse que los prefijos de los componentes del esquemático y PCB corresponden
Please reset the component ID of corresponding schematic or corresponding PCB too = Por favor restablecer también el ID del componente del esquemático o PCB correspondiente
Do you want to continue? = ¿Quieres continuar?
Reset Component ID = Restablecer ID del Componente
Component ID reset successfully! = ¡Componente ID se ha restablecido exitosamente!
Convert to PCB = Convertir a PCB
Update PCB = Actualizar PCB
Shortcut Keys Setting = Configurar Atajos de Teclado
Edit Symbol... = Editar Símbolo...
Highlight Net... = Resaltar Conexión...
Simulate = Simular
Simulation = Simulación
Standard Mode = Modo Estándar
Simulation Mode = Modo Simulación
Change to Standard Mode = Cambiar a Modo Estándar
Change to Simulation Mode = Cambiar a Modo Simulación
Welcome to Use LCEDA = Bienvenido a Usar LCEDA
Welcome to Use EasyEDA = Bienvenido a Usar EasyEDA
Enable Education Edition Features for Free >>> = Habilitar Características de la Edición Educativa Gratis >>>
Quick Start = Inicio Rápido
More Help = Más Ayuda
Explore = Explorar
Message = Mensaje
[start]
Example = Ejemplo
Forum = Foro
Tutorials = Tutoriales
Videos = Videos
[/start]
Custom Data = Datos Personalizados
LCEDA = LCEDA

Copy Result Image = Copiar Imagen Resultante
Export Result Image = Exportar Imagen Resultante
Simulation Result = Resultado de Simulación
Simulation Results... = Resultados de la Simulación...
Simulate this Sheet = Simular esta Hoja
Simulate this Project = Simular este Proyecto
Non-simulation mode, please switch to the simulation mode first and then run = Modo simulación no activado, por favor cambiar primero al modo simulación y luego ejecutar simulación
Run the Document = Ejecutar el Documento
Run the Project... = Ejecutar el Proyecto...
Netlist for Document = Lista de Redes para Documento
Netlist for Project = Lista de Redes para Proyecto
LTspice for This Sheet... = LTspice para Esta Hoja...
Spice for this Project... = Spice para este Proyecto...
Protel/Altium for PCB... = Protel/Altium para PCB...
PADS for PCB... = PADS para PCB...
FreePCB for PCB... = FreePCB para PCB...
Eagle for PCB... = Eable para PCB...
Kicad for PCB... = Kicad para PCB...
OrCAD for PCB... = OrCAD para PCB...
BOM report... = Informe BOM...
BOM for Document... = BOM para Documento...
BOM for Project... = BOM para Proyecto...
Pin Manager... = Administrador de Pin...
Spice Model... = Modelo Spice...
Layer Manager... = Administrador de capa...
Net Color... = Color de Redes...
Design Rule... = Diseñar regla...
Copper Area = Área de Cobre
Rebuild Selected = Reconstruir Seleccionado
Rebuild All = Reconstruir Todo
Copper Area Manager... = Administrador de Área de Cobre...
Export Pick and Place File = Exportar Archivo "Pick & Place"
Measure Distance = Medir Distancia
Set Canvas Origin by Mouse Location = Marcar el origen del Canvas con el ratón
Generates Pick and Place File = Generar Archivo "Pick & Place"
Unroute All = Desrutear Todo
Auto Route = Auto Ruteo
Export Autorouter File(DSN) = Exportar Archivo de Autoruteo(DSN)
Import Autorouter Session File(SES) = Importar Archivo de Sesión de Autoruteo(SES)
Autorouter File(DSN) = Archivo de Autoruteo(DSN)
Autorouter Session File(SES) = Archivo de Sesión de Autoruteo(SES)
Terminate Routing Automatically = Terminar rutas automaticamente
Delete Segments = Borrar Segmentos
Unroute Connections = Desrutear Conexiones
Unroute Connection = Desrutear Conexión
Unroute Nets = Desrutear Redes
Select = Seleccionar
Segments = Segmentos
Connection = Conexión
Net = Red
Apply Design Rule While Routing and Auto Placing Via = Aplicar Regla de Diseño mientras establece ruta y colocando automáticamente vías

Add SubPart = Añadir SubPart
Annotate... = Numerar...
Config = Configurar

Help = Ayuda
About = Acerca de
Shortcut Keys = Atajos de Teclado
FAQ = Preguntas Frecuentes
Tutorials = Tutoriales
Basic Tutorials = Tutoriales básicos
Video Tutorials = Video tutoriales
Essential Check = Listado de Esencial
Simulation Tutorials = Tutoriales de simulación
Updated Instructions = Instrucciones Actualizados
Open File Format = Abrir Formato de Archivo
About Upgrade = Acerca de Mejoras
User Forum = Foro de Usuario
Feature Request = Petición de Característica
Feature Requests = Petición de Características
Bug Report = Reportar Error
Bug Reports = Reportar Errores
Tips & Skill = Consejos & Habilidades
Ask for Help = Preguntar por Ayuda
Schematic Capture = Captura de Esquemático
Spice Simulation = Simulación de Spice
Non-simulation mode = Modo de Simulación Desactivado
PCB Layout = Diseño de PCB
General Discussion = Discusión General
More Information = Más Información
Privacy Policy = Políticas de Privacidad
#Terms of Use & Privacy Policy
Terms of Service = Terminos del servicio
Plans and Pricing = Planes y precios
Help Translate = Ayuda a Traducir
About Us = Acerca de nosotros
Contact Us = Contáctanos
Change History = Historial de Cambios
Join Us = ¡Únete!
#PCB Fabrication Capabilities
PCB Fabrication = Fabricación de PCB
Order Capabilities = Capacidades del Pedido
Order Price = Precio del pedido
Order Essential Check = Listado de Esenciales del Pedido
Order FAQ = Preguntas Frecuentes del Pedido
Order Process = Proceso del Pedido
Full Screen = Pantalla Completa

Support = Soporte
[leftNavTabs]
Support = Soporte
[/leftNavTabs]
Historical Records... = Historial de registros...
Extensions = Extensiones
Order PCB... = Ordenar PCB...
Import Changes = Importar Cambios
Press {0}F11{1} to switch to full screen. = Presiona {0}F11{1} para cambiar a pantalla completa.
Delete Selected = Eliminar selección
Simulate... = Simular...
Config = Configurar
Terms of Service & Privacy Policy = Terminos de Servicio y Política de privacidad
Help Topics = Temas de Ayuda
3D Model(obj) = Modelo 3D(obj)
3D Model(step) = Modelo 3D(step)
SVG Source... = Fuente SVG...
File Source = Archivo Fuente
Group These Items as a Symbol = Agrupar Estos Objetos como Símbolo
Group These Items as a Footprint = Agrupar Estos Objetos como Huella
Set Canvas Origin = Establecer Origen de Canvas
Document Setting = Configuración del Documeto
Sheet Properties = Propiedades de Hoja
Set Board Outline = Establecer Contorno de Tarjeta
Teardrop... = Gota de Agua...
Panelize... = Panelizar...
Check Dimension = Comprobar Dimensiones
Smart Dimension = Dimensiones Inteligentes
Footprint Wizard = Asistente de Huella
Footprint Wizard... = Asistente de Huella...
Select package type = Selecciona tipo de empaquetado
Smart Dimension Properties = Propiedades de Dimensiones Inteligentes
Global Delete = Eliminar Global
Cross Probe = Búsqueda cruzada
Cross Probe and Place = Búsqueda Cruzada y Colocación
Paper Size = Tamaño del papel
Register = Registro
User Center = Centro de usuario

By Mouse Location = Por la ubicación del ratón
Set Coordinate = Establecer coordenadas
By Coordinates... = Por las coordenadas...
By Center of Pads = Por el centro de pads
By Center Grid of Symbols = Por el centro de la cuadrícula de símbolos

#Schematic Canvas Properties
Properties = Propiedades
Apply = Aplicar
Save as default = Guardar como predeterminado
Canvas Properties = Propiedades del lienzo
Width = Ancho
Height = Altura
Background = Fondo
Visible Grid = Rejilla visible
Grid Visible = Rejilla visible
Real-Time Track Length = Longitud de la pista en tiempo real
Display Real-Time Track Length = Mostrar longitud de la pista en tiempo real
Grid Color = Color de la rejilla
Grid Size = Tamaño de la rejilla
Grid Style = Estilo de la rejilla
Grid.Line Width = Ancho de línea de la rejilla
Grid.Line Spacing = Espaciado de línea de la rejilla
Copper to Board Outline = De cobre a contorno de placa
Improve Fabrication = Mejorar fabricación
Spoke Width = Ancho del radio
Stroke Color = Color del trazo
Stroke Width = Ancho del trazo
Stroke Style = Estilo del trazo
Fill Color = Color de relleno
Selected Objects = Objetos seleccionados
Frame Size = Tamaño del marco
Alt Snap = Snap alternativo
Snap size when pressing the Alt key = Tamaño de snap cuando se presiona la tecla Alt
Prefix Start = Prefijo de inicio

#Text Properties
Text Properties = Propiedades de texto
Text = Texto
Color = Color
Font Family = Familia de la fuente
Font Size = Tamaño de la fuente
Font Weight = Grosor de la fuente
Font Style = Estilo de la fuente
Text Type = Tipo de texto
Text Anchor = Anclaje de texto
Baseline = Línea de base
(Auto) = (Auto)
(auto) = (auto)
start = inicio
middle = medio
end = fin
inherit = heredar
comment = comentario
spice = spice
normal = normal
italic = cursiva
Default = Predeterminado
Add = Añadir
bold = negrita
bolder = más negrita
lighter = más claro
Failed to parse the font file: {name} = Error al analizar el archivo de fuente: {name}
Please select a font file of ttf or woff format. = Seleccione un archivo de fuente en formato ttf o woff.
Add font success: {name} = Fuente agregada correctamente: {name}
Failed to add font: {name} = Error al agregar la fuente: {name}
Add Font = Agregar fuente
Failed to parse cached font: {name} = Error al analizar la fuente en caché: {name}
Load cached fonts fail! = ¡Error al cargar las fuentes en caché!

#Stroke
Stroke Color = Color del trazo
Stroke Width = Ancho del trazo
Stroke Style = Estilo del trazo
Fill Color = Color de relleno
X Radius = Radio X
Y Radius = Radio Y

#spice
Switch mode = Cambiar modo
The current documents will be closed, and reopen after switching mode, do you want to continue? = Los documentos actuales se cerrarán y se volverán a abrir después de cambiar de modo. ¿Desea continuar?
PCB related documents are not allowed in emulation mode = Los documentos relacionados con PCB no están permitidos en modo de emulación.
Please change the editor to "Simulation" mode first at the top left corner. = Por favor, cambie el editor al modo "Simulación" primero en la esquina superior izquierda.
Please change the editor to "Standard" mode first at the top left corner. = Por favor, cambie el editor al modo "Estándar" primero en la esquina superior izquierda.
Common = Común
spice.open = spice.abrir
spice.close = spice.cerrar
Sources = Fuentes
Instrument = Instrumento
Transistors = Transistores
Digital Circuits = Circuitos digitales
Operational Amplifier = Amplificador operacional
multimeter = multímetro
multimeter Settings = configuración del multímetro
FunctionGenerator Settings = Configuración del generador de funciones
Voltage Source Settings = Configuración de la fuente de tensión
Current Source Settings = Configuración de la fuente de corriente
Powersw Settings = Configuración del interruptor de potencia
Resistor Settings = Configuración de las resistencias
Capacitor Settings = Configuración de los condensadores
Diode Settings = Configuración de los diodos
voltPowersw Settings = Configuración del interruptor de potencia de voltaje
Inductor Settings = Configuración de las bobinas
VCVS Settings = Configuración de VCVS
CCCS Settings = Configuración de CCCS
VCCS Settings = Configuración de VCCS
CCVS Settings = Configuración de CCVS
JFET Settings = Configuración de JFET
FET Settings = Configuración de FET
Transmission Line Settings = Configuración de la línea de transmisión
Oscilloscope Settings = Configuración del osciloscopio
XFMR Settings = Configuración de XFMR
LOGIC Settings = Configuración de lógica
LOGICSTATE Settings = Configuración de estado lógico
DIGITALCLOCK Settings = Configuración del reloj digital
Potentiometer Settings = Configuración del potenciómetro
MUTUAL_INDUCTORS Settings = Configuración de inductores mutuos
NE555 Settings = Configuración de NE555
THREE_PHASE Settings = Configuración de tres fases
Logic_Probe Settings = Configuración de la sonda lógica
78XX Settings = Configuración de 78XX
79XX Settings = Configuración de 79XX
OPAMP5PEE Settings = Configuración de OPAMP5PEE
OPAMP5PEECN Settings = Configuración de OPAMP5PEECN
OPAMP3PEE Settings = Configuración de OPAMP3PEE
OPAMP3PEECN Settings = Configuración de OPAMP3PEECN
DELAY_FUSE Settings = Configuración del fusible de retardo
Ratio = Ratio
K[%] = K[%]
Model = Modelo
States = Estados
Voltage[V] = Voltaje [V]
Voltage gain[V/V] = Ganancia de voltaje [V/V]
Current gain[A/A] = Ganancia de corriente [A/A]
Transconductance[Mho] = Transconductancia [Mho]
Transresistance[Ω] = Transresistencia [Ω]
Voltage Source Type = Tipo de fuente de voltaje
Current Source Type = Tipo de fuente de corriente
multimeter type = tipo de multimetro
power type = tipo de potencia
Voltmeter Resistance(R)(Ω) = Resistencia del Voltímetro (R)(Ω)
Amperometer Resistance(R)(Ω) = Resistencia del Amperímetro (R)(Ω)
mu.V = mu.V
mu.A = mu.A
Sine Wave = Onda Senoidal
Triangular Wave = Onda Triangular
Rectangular Wave = Onda Rectangular
AC = CA (Corriente Alterna)
DC = CC (Corriente Continua)
SINE = SENO
PULSE = PULSO
EXP = EXP
SFFM = SFFM
PWL = PWL
B.spice = B.spice
DC Value[V] = Valor DC [V]
DC Value[A] = Valor DC [A]
DC offset[V] = Desplazamiento DC [V]
DC offset[A] = Desplazamiento DC [A]
Amplitude[V] = Amplitud [V]
Amplitude[A] = Amplitud [A]
Freq[Hz] = Frecuencia [Hz]
Theta[1/s] = Theta [1/s]
Tdelay[s] = Retardo [s]
Phi[deg] = Phi [grados]
Tperiod[s] = Periodo [s]
Ton[s] = Duración encendido [s]
Tfall[s] = Tiempo de caída [s]
Trise[s] = Tiempo de subida [s]
Von[V] = Encendido [V]
Von[A] = Encendido [A]
Vinitial[V] = Valor inicial [V]
Vinitial[A] = Valor inicial [A]
Vpulsed[V] = Valor del pulso [V]
Vpulsed[A] = Valor del pulso [A]
Rise Delay[s] = Retardo de subida [s]
Rise Tau[s] = Tau de subida [s]
Fall Delay[s] = Retardo de caída [s]
Fall Tau[s] = Tau de caída [s]
Carrier Freq[Hz] = Frecuencia de portadora [Hz]
Modulation Index = Índice de modulación
Signal Freq[Hz] = Frecuencia de señal [Hz]
Time[s] = Tiempo [s]
Value[V] = Valor [V]
Value[A] = Valor [A]
Waveforms = Formas de onda
Duty cycle[%] = Ciclo de trabajo [%]
Amplitude[Vp] = Amplitud [Vp]
Offset[V] = Desplazamiento [V]
Rise/Fall Time[sec] = Tiempo de subida/bajada [s]
Capacitance[F] = Capacitancia [F]
sComponent = Componente s
Inductance[H] = Inductancia [H]
Gbw = Ancho de banda de ganancia
Slewrate = Tasa de subida
Avol = Ganancia de voltaje
Rout(Ω) = Resistencia de salida (Ω)
Rin(Ω) = Resistencia de entrada (Ω)
Ibias[A] = Corriente de polarización [A]
Inhi[V] = Entrada alta [V]
Inlo[V] = Entrada baja [V]
Isc[A] = Corriente de cortocircuito [A]
Outhi[V] = Salida alta [V]
Outlo[V] = Salida baja [V]
Vabsmax[V] = Valor absoluto máximo [V]
Vmin[V] = Valor mínimo [V]
Iq[A] = Corriente en reposo [A]
Cin[F] = Capacitor de entrada [F]
high = alta
low = baja
Oscilloscope = Osciloscopio
Logic Analyzer = Analizador lógico
Channel_A = Canal_A
Channel_B = Canal_B
Channel A = Canal A
Channel B = Canal B
Time = Tiempo
Reverse = Invertir
Simulation file exceed = El archivo de simulación es demasiado grande y se ha detenido por razones de rendimiento.
The simulation file is too large and has been stopped for performance reasons. = El archivo de simulación es demasiado grande y se ha detenido por motivos de rendimiento.
Timebase = Base de tiempo
Scale: = Escala:
X pos.(Div): = Posición X (Div):
Y pos.(Div): = Posición Y (Div):
View meter... = Ver medidor...
The circuit has components without simulation model: El circuito tiene componentes sin modelo de simulación.
Your simulation interval is too short to simulate, please wait 5 seconds later and try again; if still show this message, may be you simulated over 500 times the maximum simulation times per day. = Su intervalo de simulación es demasiado corto para simular, espere 5 segundos y vuelva a intentarlo; si todavía muestra este mensaje, es posible que haya simulado más de 500 veces el número máximo de simulaciones por día.
Resistor1_US = Resistor1_US
Resistor1_EU/IEC = Resistor1_EU/IEC
Resistor1_3D = Resistor1_3D
Capacitor1_US = Capacitor1_US
Capacitor1_EU/IEC = Capacitor1_EU/IEC
Capacitor1_3D = Capacitor1_3D
Rheostat_US = Rheostat_US
Rheostat_EU/IEC = Rheostat_EU/IEC
Rheostat_3D = Rheostat_3D
Capacitor_Electrolytic_US = Capacitor electrolítico_US
Capacitor_Electrolytic_EU/IEC = Capacitor electrolítico_EU/IEC
Capacitor_Electrolytic_3D = Capacitor electrolítico_3D
Inductor_US = Inductor_US
Inductor_EU/IEC = Inductor_EU/IEC
Inductor_3D = Inductor_3D
Resistor2_US = Resistor2_US
Resistor2_EU/IEC = Resistor2_EU/IEC
Resistor2_3D = Resistor2_3D
Multimeter = Multímetro
Multimeter_3D = Multímetro_3D
Oscilloscope = Osciloscopio
Oscilloscope_3D = Osciloscopio_3D
Signal_Generator = Generador de señales
Signal Generator_3D = Generador de señales_3D
Wattmeter = Vatímetro
Wattmeter_3D = Vatímetro_3D
NSSWS1080T_3D = NSSWS1080T_3D
Voltage_Source_VDC = Fuente de voltaje_VDC
Voltage_Source_VSin = Fuente de voltaje_VSin
Voltage_Source_VPULSE = Fuente de voltaje_VPULSE
Voltage_Source_VEXP = Fuente de voltaje_VEXP
Voltage_Source_VSFFM = Fuente de voltaje_VSFFM
Voltage_Source_VPWL = Fuente de voltaje_VPWL
Voltage_Source_V_Behavioral_Source = Fuente de voltaje_Fuente de comportamiento
Current_Source_IDC = Fuente de corriente continua
Current_Source_ISin = Fuente de corriente sinusoidal
Current_Source_IPULSE = Fuente de corriente pulso
Current_Source_IEXP = Fuente de corriente exponencial
Current_Source_ISFFM = Fuente de corriente FM
Current_Source_IPWL = Fuente de corriente PWL
Current_Source_I_Behavioral_Source = Fuente de corriente comportamental
CCCS_1 = Amplificador de corriente controlado por corriente 1
CCCS_2 = Amplificador de corriente controlado por corriente 2
CCVS_1 = Amplificador de voltaje controlado por corriente 1
CCVS_2 = Amplificador de voltaje controlado por corriente 2
VCCS = Amplificador de corriente controlado por voltaje
VCVS = Amplificador de voltaje controlado por voltaje
Three_Phase_Wye_Load = Carga trifásica en estrella
Three_Phase_Delta_Load = Carga trifásica delta
78XX = Regulador de voltaje positivo 78XX
79XX = Regulador de voltaje negativo 79XX
555 = Temporizador 555
555_3D = Temporizador 3D 555
Transformer_US = Transformador estadounidense
Transformer_EU/IEC = Transformador europeo/IEC
Transformer_Center_Tapped_US = Transformador estadounidense de punto central
Transformer_Center_Tapped_EU/IEC = Transformador europeo/IEC de punto central
Mutual_Inductor_US = Inductor mutuo estadounidense
Mutual_Inductor_EU/IEC = Inductor mutuo europeo/IEC
Mutual_Inductor2_US = Segundo inductor mutuo estadounidense
Mutual_Inductor2_EU/IEC = Segundo inductor mutuo europeo/IEC
OR2EE_US = Puerta lógica OR2 estadounidense
OR3EE_US = Puerta lógica OR3 estadounidense
OR4EE_US = Puerta lógica OR4 estadounidense
OR2EE_CN = Puerta lógica OR2 china
OR3EE_CN = Puerta lógica OR3 china
OR4EE_CN = Puerta lógica OR4 china
NOR2EE_US = Puerta lógica NOR2 estadounidense
NOR3EE_US = Puerta lógica NOR3 estadounidense
NOR4EE_US = Puerta lógica NOR4 estadounidense
NOR2EE_CN = Puerta lógica NOR2 china
NOR3EE_CN = Puerta lógica NOR3 china
NOR4EE_CN = Puerta lógica NOR4 china
AND2EE_US = Puerta lógica AND2 estadounidense
AND3EE_US = Puerta lógica AND3 estadounidense
AND4EE_US = Puerta lógica AND4 estadounidense
AND2EE_CN = Puerta lógica AND2 china
AND3EE_CN = Puerta lógica AND3 china
AND4EE_CN = Puerta lógica AND4 china
NAND2EE_US = Puerta lógica NAND2 estadounidense
NAND3EE_US = Puerta lógica NAND3 estadounidense
NAND4EE_US = NAND de 4 entradas (EE. UU.)
NAND2EE_CN = NAND de 2 entradas (CN)
NAND3EE_CN = NAND de 3 entradas (CN)
NAND4EE_CN = NAND de 4 entradas (CN)
XOR2EE_US = XOR de 2 entradas (EE. UU.)
XOR2EE_CN = XOR de 2 entradas (CN)
XNOR2EE_US = XNOR de 2 entradas (EE. UU.)
XNOR2EE_CN = XNOR de 2 entradas (CN)
Digital_Clock_1Hz = Reloj digital de 1Hz
Logicstate_0 = Estado lógico_0
Logicstate_1 = Estado lógico_1
Logic_Probe = Sonda lógica
Buffee = Buffer
INVEE_US = Inversor (EE. UU.)
INVEE_CN = Inversor (CN)
Schmittbuffee = Buffer Schmitt
LM358N_US = Amplificador operacional LM358N (EE. UU.)
LM358N_CN = Amplificador operacional LM358N (CN)
OPAMP3PEE_US = Amplificador operacional de 3 pines (EE. UU.)
OPAMP3PEE_CN = Amplificador operacional de 3 pines (CN)
OPAMP5PEE_US = Amplificador operacional de 5 pines (EE. UU.)
OPAMP5PEE_CN = Amplificador operacional de 5 pines (CN)
Voltage_Controlled_Switch = Interruptor controlado por voltaje
Current_Controlled_Switch = Interruptor controlado por corriente
FUSE = Fusible
Delay_Fuse = Fusible de retardo
Transmission_Line = Línea de transmisión
Crystal = Cristal
DFFEE = Flip-flop D
TFFEE = Flip-flop T
JKFFEE = Flip-flop JK
SRFFEE = Flip-flop SR
SRLATCHEE = Latch SR
SRNANDFFEE = Flip-flop NAND SR
SRNORFFEE = Flip-flop NOR SR
INVTSEE = Compuerta NOT (TTL)
INVODEE = Compuerta NOT (Open Drain)
Schmittbuffee = buffer Schmitt
Cbuffer = Buffer capacitivo
SPDT_Open = Interruptor SPDT abierto
SPDT_Close = Interruptor SPDT cerrado
SPST_Close = Interruptor SPST cerrado
SPST_Open = Interruptor SPST abierto
Fast_Crystal = Cristal rápido
Lamp = Lámpara
BCD_Segment = Segmento BCD
Seven_Segment = Display de siete segmentos
Traffic_Light = Semáforo
Lamp Settings = Configuración de la lámpara
Power[W] = Potencia [W]
Dropout Voltage[V] = Tensión de caída [V]
Current[A] = Corriente [A]
Threshold[V] = Umbral [V]
Clock Rate = Frecuencia de reloj
TrafficLight Settings = Configuración del semáforo
BCDSegment Settings = Configuración del segmento BCD
SevenSegment Settings = Configuración del display de siete segmentos
SPDT Settings = Configuración del interruptor SPDT
SPST Settings = Configuración del interruptor SPST
LogicAnalyzer Settings = Configuración del analizador lógico
Fuse Settings = Configuración del fusible
Wattmeter Settings = Ajustes del vatímetro
open = abierto
close = cerrado
Common Anode = Ánodo común
Common Cathode = Cátodo común
AC Amplitude = Amplitud de CA
AC Phase = Fase de CA
There are some parts haven't spice model, please use "EElib" and "Spice Symbol" at "Libraries" of "Simulation" mode, or you can assign the spice model for them: = Hay algunas partes que no tienen un modelo Spice, por favor utiliza "EElib" y "Spice Symbol" en las "Librerías" del modo "Simulación", o puedes asignarles el modelo Spice.

#Pin
Pin Properties = Propiedades del Pin
Orientation = Orientación
Line 45° = Línea a 45°
Line 90° = Línea a 90°
Arc 45° = Arco a 45°
Arc 90° = Arco a 90°
Free Angle = Ángulo libre
Start X = Inicio en X
Start Y = Inicio en Y
Length = Longitud
Name = Nombre
name = nombre
Number = Número
Spice Pin Order = Orden de Pin Spice
Display Number = Mostrar número
Clock = Reloj
Show = Mostrar
Electric = Eléctrico

#Junction
Junction Properties = Propiedades del empalme
X Location = Ubicación en X
Y Location = Ubicación en Y
Size = Tamaño
Color = Color

#Net Label
Net Label = Etiqueta de la Net

#Part
Prefix = Prefijo

#Image Properties and Dialog
Add Image = Agregar imagen
Image Properties = Propiedades de la imagen
Image URL = URL de la imagen
Input an image URL = Ingrese una URL de imagen
Invalid image URL = URL de imagen inválida
Invalid Prefix = Prefijo inválido
Failed to load the image = Error al cargar la imagen
Image URL contains special characters = La URL de la imagen contiene caracteres especiales
From Web URL = Desde una URL de la web
From Local Computer = Desde la computadora local
Please select a png/gif/jpg file. = Por favor seleccione un archivo png/gif/jpg.
Please select an image file. = Por favor seleccione un archivo de imagen.
Select an image file = Seleccionar un archivo de imagen
Insert Image to PCB = Insertar imagen en el PCB
Tolerance = Tolerancia
tolerance = tolerancia
capacitance = capacitancia
frequency = frecuencia
Rated Voltage = Voltaje nominal
Rated Current = Corriente nominal
resistance = resistencia
Resistance = Resistencia
Resistance[Ω] = Resistencia[Ω]
inductance = inductancia
Operating Temperature = Temperatura de operación
Shape Invert = Invertir forma
Image Size = Tamaño de la imagen
Color Tolerance = Tolerancia de color
Simplify Level = Nivel de simplificación
Corner Threshold = Umbral de esquina

#PCB Canvas Properties
Units = Unidades
Snap Size = Tamaño de ajuste
Other = Otro
Routing Width = Ancho de enrutamiento
[router]
Routing Width = Ancho de enrutamiento
[/router]
Please using hotkey {0}{key1}{1} or {2}{key2}{3} to change track width while on routing. = Porfavor use la tecla de acceso directo {0}{key1}{1} o {2}{key2}{3} para cambiar el ancho de la pista durante el enrutamiento.
Routing Angle = Ángulo de enrutamiento
Routing Conflict = Conflicto de enrutamiento
Remove Loop = Eliminar ciclo
Cut SilkScreen = Cortar serigrafía
Grid = Rejilla	
Grid 90 = Rejilla a 90°
Grid 45 = Rejilla a 45°
Copper Zone = Zona de cobre
Visible = Visible
Invisible = Invisible
Ignore = Ignorar
Block = Bloquear
RoundTrack = Pista redondeada

#Track
Track Properties = Propiedades de la Pista
Layer = Capa
Net = Red
Start X = Inicio en X
Start Y = Inicio en Y
End X = Fin en X
End Y = Fin en Y
ID = Identificación

#Pad Properties
Pad Properties = Propiedades del Pad
Shape = Forma
Hole(D) = Orificio(D)
Center X = Centrado en X
Center Y = Centrado en Y
Round = Redondeado
Oval = Ovalado
Hole Shape = Forma del orificio
Slot = Ranura
Hole(Length) = Longitud del orificio
Plated = Plateado
None = Sin plateado
Paste Mask Expansion = Expansión de la máscara de pasta
Solder Mask Expansion = Expansión de la máscara de soldadura

#Via Properties
Via Properties = Propiedades de la Vía
Diameter = Diámetro
Drill Diameter = Diámetro de la perforación

#Hole Properties
Hole Properties = Propiedades del Agujero


#TEXT
Text Properties = Propiedades del Texto
Line Width = Ancho de línea
Rotation = Rotación
Fonts Management = Administración de Fuentes

#Dimension Properties
Dimension Properties = Propiedades de las Dimensiones

#Footprint Properties
Component Properties = Propiedades del Componente
Display Prefix = Mostrar Prefijo
Pin Name = Nombre del Pin
Pin Number = Número del Pin
Spice Pin Number = Número de Pin SPICE
Graphics = Gráficos
Pattern = Patrón

#Arc Properties
Arc Properties = Propiedades del Arco
Start Angle = Ángulo de Inicio
End Angle = Ángulo Final
Rotation Direction = Dirección de Rotación

#Rect Properties
Rect Properties = Propiedades del Rectángulo
Round radius = Radio de la Esquina

#Circle Properties
Circle Properties = Propiedades del Círculo
Radius = Radio

#CopperArea Properties
CopperArea Properties = Propiedades del Área de Cobre
Clearance = Espaciado
Pad Connection = Conexión del Pad
Direct = Directo
Spoke = Radio
Keep Island = Mantener Isla
Fill Style = Estilo de Relleno
CopperArea conflict: copper area outlines in same layer with different net names must not overlap = Conflicto de Área de Cobre: Las áreas de cobre en la misma capa con diferentes nombres de red no deben superponerse.
Copper area rebuild complete! You can set "Copper Zone" as "Visible" at the right-hand property panel after single click the empty area. = ¡Reconstrucción de Área de Cobre Completa! Puede establecer "Zona de Cobre" como "Visible" en el panel de propiedades a la derecha después de hacer clic una vez en el área vacía.
Please create board outline first. = Por favor, cree el contorno de la placa primero.
Board outlines are not closed. = Los contornos de la placa no están cerrados.
Rebuild CopperArea = Reconstruir Área de Cobre
Edit Points = Editar Puntos
Direct = Directo
Spoke = Radio
No Solid = Sin Relleno
Board Cutout = Recorte de Placa
Solid = Relleno Sólido
[copperArea]
None = Ninguno
[/copperArea]

#Custom Properties
Custom Properties = Propiedades Personalizadas
Fixed Properties = Propiedades Fijas
Add new parameter = Añadir Nuevo Parámetro
Add New Parameter = Añadir Nuevo Parámetro
Add New Supplier = Añadir Nuevo Proveedor
Mounted = Montado
Unknown = Desconocido

Custom = Personalizado
Scan the QR code below and open it on the mobile side = Escanea el código QR de abajo y ábrelo en tu dispositivo móvil
How to create a single layer PCB = Cómo crear una PCB de una sola capa
Currently doesn't support layout single layer directly, please refer at: = Actualmente no se admite la disposición de una sola capa directamente, por favor consulta en:

#Dialog Register
Create an account = Crear una cuenta
Username = Nombre de usuario
Password = Contraseña
Confirm Password = Confirmar contraseña
Email = Correo electrónico
Please read this before you register = Por favor, lee esto antes de registrarte
Hi {username} = Hola {username}

#Dialog lostPassword
Lost Password... = Contraseña olvidada...
Find the password using your email = Recupera la contraseña usando tu correo electrónico



#Dialog Login
Login = Iniciar sesión
Username or Email = Nombre de usuario o correo electrónico
Remember Me = Recordarme
Third party = Terceros
Login and Register = Iniciar sesión y registrarse
Your login information seems expired, please login again. Don't need to close the opening files, you can continue to save them after login. = Tu información de inicio de sesión parece haber caducado, por favor vuelve a iniciar sesión. No es necesario que cierres los archivos que tengas abiertos, podrás continuar guardándolos después de iniciar sesión.

#Dialog Reset Password
Reset a password using your email = Restablecer una contraseña usando tu correo electrónico
Your registered email = Tu correo electrónico registrado

#Dialog Reaction
Re-send an activation code to your email = Reenviar un código de activación a tu correo electrónico

#Dialog Invite
Invite friends to register = Invitar a tus amigos a registrarse
Your friend's email = Correo electrónico de tu(s) amigo(s)

#Dialog Add A New Parameter
Add a new parameter = Añadir un nuevo parámetro
Key = Clave
Value.new_para = Valor.nuevo_para
In BOM = En BOM
Add into BOM = Añadir al BOM
Invalid key = Clave no válida
This field is required. = Este campo es obligatorio.

#Dialog Change Your Password
Change your password = Cambiar tu contraseña
Old password = Contraseña antigua
New Password = Nueva contraseña
Confirm Password = Confirmar contraseña

#Dialog Create New Design
Save as a New Project = Guardar como un nuevo proyecto
Save as a schematic = Guardar como esquemático
Save as Symbol = Guardar como símbolo
Save as a spice Symbol = Guardar como símbolo Spice
Save as a spice subckt = Guardar como Spice Subckt
YOU MUST CREATE A SPICE SYMBOL WITH EXACTLY THE SAME NAME AS THIS SUBCKT = DEBES CREAR UN SÍMBOLO SPICE CON EL MISMO NOMBRE QUE ESTE SUBCKT
Save as a PCB file = Guardar como archivo PCB
Save as Footprint = Guardar como huella
Save as a Schematic Module = Guardar como módulo de esquemático
Save as a PCB Module = Guardar como módulo de PCB
Save as 3D Model = Guardar como modelo 3D
Save as a WaveForm = Guardar como forma de onda
Title = Título
Share = Compartir
Add file = Añadir archivo
Visibility = Visibilidad
Allow Comments = Permitir comentarios
Public (Anyone can see this project but only you can modify it.) = Público (Cualquiera puede ver este proyecto pero solo tú puedes modificarlo)
Private (Only you can see and modify this project) = Privado (Solo tú puedes ver y modificar este proyecto)
Create new project success! = ¡Proyecto creado con éxito!
You can now create files under this project = Ahora puedes crear archivos bajo este proyecto.
This file must be saved under a project, choose other project or create a new project = Este archivo debe ser guardado en un proyecto. Elige otro proyecto o crea uno nuevo.
Please login to save this kind of document = Por favor inicia sesión para guardar este tipo de documento.
Duplicated project title = Título de proyecto duplicado.
#Duplicated document title
Project does not exist = El proyecto no existe.
Document does not exist = El documento no existe.
document not exists = El documento no existe.

Categories = Categorías
Project = Proyecto
Short description = Descripción corta
Content = Contenido
Modify this project info. = Modificar la información de este proyecto.
Modify this file info. = Modificar la información de este archivo.
Notice = Aviso
Search for it before creating a new one. = Búscalo antes de crear uno nuevo.
Manufacturer Part Number = Número de parte del fabricante
Supplier = Proveedor
Or = O
Supplier Part = Parte del proveedor
Supplier Part Number = Número de parte del proveedor
Link = Enlace
link = enlace
The professional function please refer at: = Para obtener información sobre la función profesional, consulte:

#Dialog Clone My Part
#Clone it to a project
#Clone it, then edit it
Clone your file = Clonar tu archivo

#Dialog Subckt
Attach a Subckt to this spice symbol = Adjuntar un Subckt a este símbolo SPICE
Subckt string = Cadena de Subckt
Spice symbol title just allow [0-9][a-z][A-Z] and _ = El título del símbolo Spice solo permite [0-9][a-z][A-Z] y _

#Design Manager
Design Manager = Gerente de Diseño
Nets = Redes
DRC Errors = Errores DRC
Are you sure you want to unroute this net? = ¿Estás seguro de que deseas desenrutar esta red?
Unroute = Desenrutar
Track Length = Longitud de la pista
Via/Hole Outer Size = Tamaño exterior del agujero/vía
Filter nets = Redes de filtro
Design Rule Checking = Verificación de reglas de diseño
Board Outline = Contorno de la placa
Plane Zone = Zona de plano
[drcRule]
Width = Ancho
DRC Width = Ancho de verificación de reglas de diseño
Length = Longitud
DRC Length = Longitud de verificación de reglas de diseño
Drill Diameter = Diámetro de taladro
DRC Drill Diameter = Diámetro de taladro de verificación de reglas de diseño
Diameter = Diámetro
DRC Diameter = Diámetro de verificación de reglas de diseño
Object = Objeto
DRC Clearance = Distancia de seguridad de verificación de reglas de diseño
[/drcRule]
#It will take a while to unroute this net, do you want to continue? = Tomará un tiempo desenrutar esta red, ¿desea continuar?
More than one netlabel is found in wire, please checked whether this is correct, if you design it on purpose, please ignore this warning. = Se encontró más de una etiqueta de red en el cable, por favor verifique si esto es correcto. Si lo diseñó a propósito, ignore esta advertencia.
Incomplete net, a complete net should contain two or more pins, if you design it on purpose, please ignore this warning. = Red incompleta, una red completa debe contener dos o más pines. Si lo diseñó a propósito, ignore esta advertencia.
This netlabel is not connected with any pin. = Esta etiqueta de red no está conectada con ningún pin.
Incomplete connection, please check. = Conexión incompleta, por favor revise.
The clearance between two objects is less than the Design Rule Checking (DRC) clearance which has different nets. = El espacio libre entre dos objetos es menor que el espacio libre de verificación de reglas de diseño (DRC) que tiene diferentes redes.
The diameter is less than Design Rule Checking (DRC) diameter = El diámetro es menor que el diámetro de verificación de reglas de diseño (DRC).
The drill diameter is less than Design Rule Checking (DRC) drill diameter = El diámetro de taladro es menor que el diámetro de taladro de verificación de reglas de diseño (DRC).
The track length is longer than Design Rule Checking (DRC) track length = La longitud de la pista es mayor que la longitud de pista de verificación de reglas de diseño (DRC).
The track width is less than Design Rule Checking (DRC) track width = El ancho de la pista es menor que el ancho de pista de verificación de reglas de diseño (DRC).

#Dialog Simulation
Show your simulation report = Mostrar informe de simulación
Download netlist = Descargar netlist
Run = Ejecutar
Components = Componentes

#Dialog Import
Import file from your computer = Importar archivo desde tu ordenador
Maximum file size: 30 MB = Tamaño máximo del archivo: 30 MB
Maximum file size: 100 MB = Tamaño máximo del archivo: 100 MB
Chose file = Elegir archivo
File Operation = Operación de archivo
Import File = Importar archivo
Extract Libs = Extraer librerías
Import File and Extract Libs = Importar archivo y extraer librerías
File type = Tipo de archivo
The file size is too large. = El tamaño del archivo es demasiado grande.
Please selected the file type. = Por favor seleccione el tipo de archivo.
No component was found! = No se encontró ningún componente.
Import successfully = Importación exitosa.
Import failed = Importación fallida.
Click OK to continue with the import = Haga clic en Aceptar para continuar con la importación.
Select None = Seleccionar Ninguno.

#Dialog Modify Symbol Information
Modify symbol information = Modificar la información del símbolo.
Spice Prefix = Prefijo Spice.
Hide Pin = Ocultar Pin.
Pin Manager = Gestor de Pines.
When a power pin is hidden, it will be marked as netlabel, you don't need to wire it. If you use it as simulation, please show it or create a GND/VCC Net for it. = Cuando se oculta un pin de alimentación, se marcará como etiqueta de red, no es necesario cablearlo. Si lo usas para la simulación, por favor muéstralo o crea una red GND/VCC para él.
Assign = Asignar.
Supplier.bom = Proveedor en BOM.
LCSC.bom = LCSC en BOM.
Price = Precio.
Quantity.bom = Cantidad en BOM.
Package.bom = Paquete en BOM.
Components.bom = Componentes en BOM.
Manufacturer Part.bom = Número de pieza del fabricante en BOM.
Manufacturer.bom = Fabricante en BOM.

One-click Purchasing at LCSC = Compra en un solo clic en LCSC
Order Parts = Pedir piezas
Export BOM = Exportar lista de materiales
Export PCB BOM = Exportar lista de materiales de PCB
Export Schematic BOM = Exportar lista de materiales del esquemático
ID.bom = ID en BOM
Name.bom = Nombre
[bom]
Name = Nombre
LCSC Assembly = Ensamble de LCSC
Value = Valor
ID = ID
Supplier = Proveedor
LCSC = LCSC
Price = Precio
Quantity = Cantidad
Package = Empaquetado
Components = Componentes
Manufacturer = Fabricante
[/bom]
Manufacturer Part = Número de parte del fabricante

#Dialog Run
Run your simulation = Ejecuta tu simulación
Transient = Transitorio
Maximum Timestep = Paso de tiempo máximo
Stop Time = Tiempo de detención
Start Time = Tiempo de inicio

AC Analysis = Análisis AC
Type of Sweep = Tipo de barrido
Number of points = Número de puntos
Start Frequency = Frecuencia de inicio
Stop Frequency = Frecuencia de detención

DC sweep = Barrido DC
Source to Sweep = Fuente a barrer
Start Value = Valor de inicio
Stop Value = Valor de detención
Increment = Incremento
DC Transfer = Transferencia DC
Output = Salida
Source = Fuente

DC op pnt = Punto de operación DC
Compute the DC operating point treating capacitances as opens and inductances as shorts = Calcule el punto de operación DC tratando las capacitancias como circuitos abiertos y las inductancias como cortocircuitos

#Dialog Share Info
Active File = Archivo activo
Active Project = Proyecto activo
Readonly = Solo lectura
Editable = Editable
Active file's owner project page = Página del proyecto propietario del archivo activo
Active project editor page = Página del editor del proyecto activo

#Dialog Document Recovery
All Projects = Todos los proyectos
Document Recovery = Recuperación de documento
Unsaved files = Archivos no guardados
Please select a file! = ¡Por favor seleccione un archivo!
Please expand the folder first, then select a document to recover. = Por favor expanda la carpeta primero y luego seleccione un documento para recuperar.
Are you sure you want to remove this backup? = ¿Está seguro de que desea eliminar esta copia de seguridad?

#Dialog Find Libs
Search = Buscar
Search Results = Resultados de la búsqueda
Search and press Enter = Buscar y presione Enter
Keywords at least 3 characters = Palabras clave de al menos 3 caracteres
Assembled = Ensamblado
Verified = Verificado
In stock = En stock
{page} of {pagecount} pages = Página {page} de {pagecount}
Common Modules = Módulos comunes
User Contributions = Contribuciones de usuario
More = Más
Add Favorite = Agregar a Favoritos
Remove Favorite = Eliminar de Favoritos
Add Sub Part = Agregar subparte
Untagged = Sin etiquetar
Package = Empaque
package = empaque
Title(PartNO) = Título (número de parte)
No Data! = ¡Sin datos!
Quantity = Cantidad
Manufacturer Part = Número de parte del fabricante
manufacturer Part = Número de parte del fabricante
Manufacturer = Fabricante
manufacturer = fabricante
voltage = Voltaje
Library = Biblioteca
LCSC Assembled = LCSC ensamblado
JLCPCB Assembled = JLCPCB ensamblado
User Contributed = Contribuido por usuario
Symbol = Símbolo
Follow = Seguir
Types = Tipos
Classes = Clases
power = Potencia
Power = Potencia
LCSC Part# = Número de parte de LCSC
Stock = Stock
Report Error... = Reportar error...
Report Error = Reportar error
Thanks for your feedback! = ¡Gracias por su retroalimentación!
Report error success, thanks for your report! = ¡Reporte de error exitoso, gracias por su reporte!
The content must be at least 2 characters! = ¡El contenido debe tener al menos 2 caracteres!
This library is user contributed, please check before using. = Esta biblioteca es contribuida por el usuario, por favor verifique antes de usar.
[lib]
All = Todos
System = Sistema
Personal = Personal
Created = Creado
Favorite = Favorito
No Team found. Please join or create a team first. = No se encontró equipo. Por favor únase o cree un equipo primero.
Create a team = Crear un equipo
No follow user found. Please follow your friend first. = No se encontró usuario seguido. Por favor siga a su amigo primero.
[/lib]


BUY = Comprar
In Stock = En stock
Out of Stock = Sin stock
Minimum = Mínimo
Distributor = Distribuidor

Capacitance = Capacitancia
Frequency Tolerance = Tolerancia de frecuencia
Power (Watts) = Potencia (vatios)
Power - Max = Potencia máxima
Frequency = Frecuencia
Voltage Rating(Vdc,Vac) = Clasificación de voltaje (Vdc, Vac)
Voltage = Voltaje
Current Rating = Clasificación actual
Rated current = Corriente nominal
Resistance (Ohms) = Resistencia (ohmios)
Resistance(Ohms) = Resistencia (ohmios)
Inductance = Inductancia
FET Type = Tipo FET
Current Rating(Max) = Clasificación actual máxima
Impedance @ Frequency = Impedancia @ frecuencia
Voltage - Input (Max) = Voltaje de entrada máximo
Voltage - Input (Min) = Voltaje de entrada mínimo
Voltage - Supply = Voltaje de suministro
Voltage - Max = Voltaje máximo
Current - Output = Corriente de salida

#Dialog Export Your Works
Export your works = Exportar tus trabajos
Export to = Exportar a
Zoom = Zoom
Image Type = Tipo de imagen
Qualify = Calidad
0 means real size = 0 significa tamaño real
Merged layer = Capa combinada
Separated layer = Capa separada
Paged layer = Capa paginada
Layer = Capa
Export = Exportar
Mirror = Espejo
TopLayer = Capa superior
BottomLayer = Capa inferior
TopSilkLayer = Capa superior de serigrafía
Protractor Properties = Propiedades del transportador de ángulos
BottomSilkLayer = Capa inferior de serigrafía

BoardOutLine = Contorno de placa
TopAssembly = Ensamblado superior
BottomAssembly = Ensamblado inferior
Mechanical = Mecánico
DocumentLayer = Capa de documento
Inner{number} = Interna{number}
Substrate{number} = Substrato{number}
Color = Color
Full Color = Color completo
Canvas Setting = Configuración del lienzo
Full Graphics = Gráficos completos
Assembly Drawings = Dibujos de ensamblaje
Object Outlines = Contornos de objetos
Invalid file format = Formato de archivo no válido
Failed to export file = Error al exportar el archivo
Download now = Descargar ahora
Wire Width = Ancho de cable
Sheet = Hoja
Merged sheet = Hoja fusionada
Separated sheet = Hoja separada
Engine = Motor
Exporting PDF = Exportando PDF
Export 3D Model = Exportar modelo 3D
[exportDocument]
Size = Tamaño
[/exportDocument]

#Dialog Import Changes
Confirm Importing changes information = Confirmar importación de información de cambios
You can't undo this operation, Please run a Design Rule Checking (DRC) after this operation. = No podrás deshacer esta operación. Por favor, realiza una comprobación de reglas de diseño (DRC) después de esta operación.
Apply Changes = Aplicar cambios
This is a simple Design Rule Checking (DRC). = Esta es una comprobación de reglas de diseño (DRC) simple.
It just can help you to find the obvious errors = Solo puede ayudarte a encontrar errores obvios.
There are some unfinished nets, do you want to check the nets first? = Hay algunas redes sin terminar, ¿quieres revisarlas primero?
Yes, Check Nets = Sí, revisar redes
No, Keep Going = No, continuar

#Dialog Layer Manager
Configured = Configurado
Layer Name = Nombre de la capa
TopPasterLayer = Capa superior de máscara de pasta
BottomPasterLayer = Capa inferior de máscara de pasta
TopSolderLayer = Capa superior de soldadura
BottomSolderLayer = Capa inferior de soldadura
TopPasteMaskLayer = Capa superior de máscara de pasta
BottomPasteMaskLayer = Capa inferior de máscara de pasta
TopSolderMaskLayer = Capa superior de máscara de soldadura
BottomSolderMaskLayer = Capa inferior de máscara de soldadura
ComponentShapeLayer = Capa de forma de componente
LeadShapeLayer = Capa de forma de plomo
ComponentMarkingLayer = Capa de marcado de componente
Ratlines = Ratlines
Ratlines Color = Color de Ratlines
Manage Colors = Administrar colores
BoardOutline = Esquema de la placa
Multi-Layer = Multi-capa
Hole = Orificio
DRCError = Error DRC
Setting = Configuración
Drawing area = Área de dibujo
Export area = Área de exportación
Transparency(%) = Transparencia(%)
Copper Layer = Capa de cobre
Signal = Señal
Plane = Plano
Non-Signal = No señal
Other = Otro
Please delete all the objects of the layers first! The layers are: = Por favor, elimina primero todos los objetos de las capas. Las capas son:
You are converting Signal Layer to Plane Layer, There're some non-track objects remain on following layers. Please delete the objects manually on the canvas. = Estás convirtiendo la capa de señal a capa de plano, hay algunos objetos no rastreables que permanecen en las siguientes capas. Por favor, elimina los objetos manualmente en el lienzo.
Please delete all the objects of this layer first! = Por favor, elimina primero todos los objetos de esta capa.

Create Files = Create archivos
Check your {0}Gerber files{1} carefully before sending them to the factory = Comprueba tus {0}archivos Gerber{1} cuidadosamente antes de enviarlos a la fábrica
Download free Gerber Viewer (gerbv) = Descargar el visor gratuito Gerber (gerbv)
Before generating the Gerber files = Antes de generar los archivos Gerber
Please check the packages size and orientation carefully. = Por favor, compruebe cuidadosamente el tamaño y la orientación de los paquetes.
Please check for Design Rule Checking (DRC) errors in the Design Manager. = Por favor, compruebe los errores de verificación de reglas de diseño (DRC) en el Gestor de Diseño.
Please rebuild the copper area after modifying tracks and packages. = Por favor, reconstruya el área de cobre después de modificar las pistas y los paquetes.
After generating the Gerber file, please use the {0}Gerber Viewer{1} to check whether it conforms to the design requirements. = Después de generar el archivo Gerber, por favor utilice el {0}visor de Gerber{1} para comprobar si cumple con los requisitos de diseño.
Order PCB/SMT = Ordenar PCB/SMT
Found the complicated polygon that object cannot be generated at Gerber, please remove or replace = Se encontró un polígono complicado que no se puede generar en Gerber, por favor elimínelo o reemplácelo.
ID: {id}, Object: {object}, Location: {location} = ID: {id}, Objeto: {object}, Ubicación: {location}

#Dialog DRC
Item = Objeto
Value = Valor
value = valor
Unit = Unidad
Track Width = Ancho de pista
Track to Track = Pista a pista
Track to Pad = Pista a pad
Pad to Pad = Pad a pad
Via to Via =
Via Hole Size = Tamaño del orificio de vía
Realtime DRC =
{0} is too small! = ¡{0} es demasiado pequeño!
Invalid DRC Rule = Regla DRC inválida
Rule = Regla
Via Diameter = Diámetro de vía
Via Drill Diameter = Diámetro de taladro de vía
Net List = Lista de redes
Rule = Regla
Set Rule = Establecer regla
Check Object to Copper Area = Comprobar objeto con área de cobre
Show DRC Boundary while Routing = Mostrar límite de DRC mientras se enruta
Check Object to Board Outline = Comprobar objeto con el contorno de la placa
Rule name already exists! = ¡El nombre de la regla ya existe!
You should not delete default rule! = ¡No debería eliminar la regla predeterminada!
Rule list contains invalid rule setting! = ¡La lista de reglas contiene ajustes de reglas inválidos!
Duplicate rule name exists! = ¡Existe un nombre de regla duplicado!
via diameter is smaller than via drill diameter! = El diámetro de la vía es menor que el diámetro del taladro de la vía.
Currently rule name is not allowed to contain magical characters like . and $ = Actualmente no se permite que el nombre de la regla contenga caracteres mágicos como . y $

[drcRule]
All = Todos
[/drcRule]

#Dialog Update PCB
Update PCB(Synchronizing PCB from schematics) = Actualizar PCB (Sincronizando PCB desde esquemas)


#Dialog Hotkey
Change Canvas Unit = Cambiar unidad de lienzo
Copy Selected Object(s) by Reference Point = Copiar objeto(s) seleccionado(s) por punto de referencia
Fullscreen = Pantalla completa
Undo the Previous Draw = Deshacer el dibujo anterior
Set Canvas Origin by Coordinate = Establecer el origen del lienzo por coordenada
Switch to the Next Signal Layer = Cambiar a la siguiente capa de señal
Switch to the Previous Signal Layer = Cambiar a la capa de señal anterior
Switch object to top layer or bottom layer = Cambiar objeto a la capa superior o inferior
Cycle Forward to the Next Open Tabbed Document = Ciclo hacia adelante al siguiente documento con pestañas abierto
Cycle Backward to the Previous Open Tabbed Document = Ciclo hacia atrás al documento con pestañas abierto anterior
Switch to the Previous Layer(on the Numeric Keypad) = Cambiar a la capa anterior (en el teclado numérico)
Switch to the Next Layer(on the Numeric Keypad) = Cambiar a la siguiente capa (en el teclado numérico)
Toggle Layers Which is Not Active = Alternar capas que no están activas
Hotkey Setting = Configuración de teclas de acceso rápido
Document Type = Tipo de documento
Shortcut = Atajo
Function = Función
ALL = Todo
SCH = SCH
Rotate Selected Objects = Rotar objetos seleccionados
Scroll or Move Selected Left = Desplazar o mover a la izquierda los objetos seleccionados
Scroll or Move Selected Right = Desplazar o mover a la derecha los objetos seleccionados
Scroll or Move Selected Up = Desplazar o mover hacia arriba los objetos seleccionados
Scroll or Move Selected Down = Desplazar o mover hacia abajo los objetos seleccionados
Set canvas origin to the center grid of graphics in symbol; Set canvas origin to the center of pads in footprint. = Establecer el origen del lienzo en el centro de la cuadrícula gráfica del símbolo; Establecer el origen del lienzo en el centro de las pads en la huella.
Cross Document Paste = Pegar en otros documentos
Explore & Find Components = Explorar y buscar componentes
Select All = Seleccionar todo
Cancel Current Drawing = Cancelar dibujo actual
Save = Guardar
Drag Tool = Herramienta de arrastre
Draw Wire = Dibujar cable
Draw Bus = Dibujar bus
Bus Entry = Entrada de bus
Junction = Unión
Net Flag GND = Indicador de tierra
Net Flag = Indicador de net
Draw Polyline = Dibujar polilínea
Draw Polygon = Dibujar polígono
Draw Bezier = Dibujar curva de Bézier
Draw Arc = Dibujar arco
Draw Rect = Dibujar rectángulo
Draw Ellipse = Dibujar elipse
Freehand Draw = Dibujo a mano alzada
Freedraw =
Draw Text = Dibujar texto
Edit Selected Symbol = Editar símbolo seleccionado
Draw Track = Dibujar pista
Draw Circle = Dibujar círculo
Cycle Select Object at Current Location = Ciclar entre objetos en la ubicación actual
Draw Dimension = Dibujar dimensión
Draw Connect = Dibujar conexión
Draw CopperArea = Dibujar área de cobre
Change to TopLayer;<br/>Change Selected Component's Layer to TopLayer; = Cambiar a Capa Superior;<br/>Cambiar la Capa Seleccionada del Componente a Capa Superior;
Change to BottomLayer;<br/>Change Selected Component's Layer to BottomLayer; = Cambiar a Capa Inferior;<br/>Cambiar la Capa Seleccionada del Componente a Capa Inferior;
Change to Inner1 = Cambiar a Inner1
Change to Inner2 = Cambiar a Inner2
Change to Inner3 = Cambiar a Inner3
Change to Inner4 = Cambiar a Inner4
Highlight Net = Resaltar Net
Place Pad = Colocar Pad
Place Via = Colocar Vía
Measure = Medir
Change Routing Angle = Cambiar Ángulo de Ruteo
Change Routing Conflict = Cambiar Conflicto de Ruteo
Decrease Routing Width = Disminuir Ancho de Ruteo
Increase Routing Width = Aumentar Ancho de Ruteo
Decrease Snap Size = Disminuir Tamaño de Ajuste
Increase Snap Size = Aumentar Tamaño de Ajuste
Change Copper Zone Visible or Invisible = Cambiar Visibilidad o Invisibilidad de Zona de Cobre
Rebuild All Copper Area = Reconstruir Todas las Áreas de Cobre
Toggle PCB Net Display = Alternar Visualización de Red PCB
Show Property Dialog When Placing Object;<br/>Show Location Setting Dialog When Pasting Object(s) = Mostrar Cuadro de Diálogo de Propiedades al Colocar un Objeto;<br/>Mostrar Cuadro de Diálogo de Configuración de Ubicación al Pegar Objeto(s);
Show Property Dialog When Placing Object;<br/>Show Absolute Offset Dialog When Selecting Object(s);<br/>Show Location Setting Dialog When Pasting Object(s) = Mostrar Cuadro de Diálogo de Propiedades al Colocar Objeto;<br/>Mostrar Cuadro de Diálogo de Desplazamiento Absoluto al Seleccionar Objeto(s);<br/>Mostrar Cuadro de Diálogo de Configuración de Ubicación al Pegar Objeto(s);
Show Relative Offset Dialog When Selecting Object(s) = Mostrar Cuadro de Diálogo de Desplazamiento Relativo al Seleccionar Objeto(s);
Open the FAQ Page = Abrir Página de Preguntas Frecuentes
Move Object(s) by Reference Point = Mover Objeto(s) por Punto de Referencia
Choose Favorite Track Width While Routing = Elegir Ancho Favorito de Pista durante el Ruteo
Copy Selected Object(s) and Paste Repeatedly = Copiar Objeto(s) Seleccionado(s) y Pegar Repetidamente

#My Projects Tree Menu
New Project = Nuevo Proyecto
New Schematic = Nuevo Esquemático
New PCB = Nuevo PCB
New Spice Subckt = Nuevo Subckt de Spice
Modify = Modificar
Delete = Eliminar
Add sub part = Añadir Subparte
Clone = Clonar
Version History = Historial de Versiones
Refresh List = Actualizar Lista
Create New Project = Crear Nuevo Proyecto
Delete = Eliminar
Attachment = Adjunto
Archive = Archivo
Transfer = Transferir
Manage Project = Administrar Proyecto

#Dialog Verify Package
Footprints Verification = Verificación de Huellas

#Dialog Edit Polygon Pad points
Edit Points = Editar Puntos
Center point is outside the pad = El punto central está fuera del pad
Hole should be inside the pad = El agujero debe estar dentro del pad
Hole is draggable = El agujero se puede arrastrar

#My Part Tree Menu
Clone = Clonar
Reload parts = Recargar componentes
Layers = Capas

#Dialog Preferences
Language = Idioma
Display Name = Nombre de visualización
HotKey Sync = Sincronización de teclas de acceso rápido
My Theme Sync = Sincronización de mi tema
Document Recovery Setting = Configuración de recuperación de documentos
Enable auto backup = Habilitar copia de seguridad automática
Maximum backup level = Nivel máximo de copia de seguridad
Auto backup interval = Intervalo de copia de seguridad automática
minutes = minutos
Save to Server = Guardar en el servidor
Load from Server = Cargar desde el servidor


#Dialog Schematic Library Wizard
Symbol Wizard = Asistente de símbolos
Style = Estilo
Picture = Imagen
Pin Names = Nombres de pines
Contributor = Colaborador
contributor = colaborador
owner = propietario

#Dialog Annotate
Annotate = Numerar
Scope = Alcance
Active Schematic only = Solo esquemático activo
All Opened Schematics = Todos los esquemáticos abiertos
Method = Método
Re-annotate all = Volver a numerar todo
Keep existing annotation = Mantener la numeración actual
Direction = Dirección
Rows = Filas
Cols = Columnas
Reset = Reiniciar

#Dialog Order
Order... = Ordenar...
PCB Qty. = Cantidad PCB
PCB Thickness = Espesor PCB
PCB Dimension = Dimensiones PCB
Automatic calculation = Cálculo automático
PCB Color = Color PCB
Green = Verde
White = Blanco
Blue = Azul
Red = Rojo
Yellow = Amarillo
Black = Negro
Purple = Morado
Copper = Cobre
Gold = Oro
Silver = Plata
Surface Finish = Acabado superficial
Hasl = HASL
Hasl(Lead Free) = HASL (sin plomo)
ENIG = ENIG

#Dialog Hot Key config
Restore All Default Shortcuts = Restaurar todos los accesos directos predeterminados
Save Changes = Guardar cambios



#Dialog Polyline Maybe Wire
To connect electrical elements, please use Wire (W hotkey) and not Line (L hotkey). = Para conectar elementos eléctricos, use la opción Cable (tecla de acceso directo W) en lugar de la opción Línea (tecla de acceso directo L).

Anonymous File = Archivo anónimo
Anonymous File can not be cloned, but you can open it, then save it as a new file. = No se puede clonar el archivo anónimo, pero puede abrirlo y guardarlo como un nuevo archivo.
Free Documents = Documentos gratuitos
You must close the file before delete it! = ¡Debe cerrar el archivo antes de eliminarlo!
Offline Project = Proyecto sin conexión

#Message box
Confirmation = Confirmación
Alert = Alerta
Information = Información
information = Información
Prompt = Mensaje
Error = Error
error = Error
error! = ¡Error!
Warning = Advertencia
Imported ok! = Importado correctamente
Some changes have not been saved. = Algunos cambios no se han guardado.
Your file hasn't been saved. Please save first! = Su archivo no se ha guardado. ¡Guárdelo primero!
Your file hasn't been saved. Are you sure you want to close it? = Su archivo no se ha guardado. ¿Está seguro de que desea cerrarlo?
Error! Please try again later. = ¡Error! Por favor, inténtelo de nuevo más tarde.
Are you sure you want to reload this page? = ¿Está seguro de que desea volver a cargar esta página?
Are you sure you want to leave this page? = ¿Está seguro de que desea abandonar esta página?
Confirm Reload = Confirmar volver a cargar
Confirm Close = Confirmar cierre
Reload this page = Volver a cargar esta página
Leave this page = Abandonar esta página
Stay on this page = Permanecer en esta página
Don't reload = No volver a cargar
No connect flag only can be placed on Pin dot or the wire which is connected one Pin. = La bandera de sin conexión solo se puede colocar en el punto de pin o en el cable que está conectado a un pin.
can not be placed on the wire which is placing No Connect Flag. = No se puede colocar en el cable que está colocando la bandera de sin conexión.
The footprint transfer to LCSC library class successfully = La huella se transfirió correctamente a la clase de biblioteca LCSC.
Device/Footprint goes into "SMT Device/Footprint Verified" list successfully = El dispositivo / huella pasa a la lista "Dispositivos / Huellas verificados de montaje en superficie" con éxito.

Load failure! =
Load projects failed =
error info = Información del error
error information = información del error
Guest can't create a new project. Please login! =
Please create a project before you do this! = Por favor crea un nuevo proyecto antes de hacer esto
Add Part success = Añadir componente completado
Click the new part and then edit it! =
Delete my work = Eliminar mi trabajo
Delete my work. (Only deletes it from this list but not from the server) =
Do you confirm this? = ¿Deseas confirmar esto?
Successfully deleted! = ¡Eliminación completada!
Successfully Copied! =
Cloning success! = ¡Clonación completada!
Your title is too short! = ¡El título es demasiado corto!
Remove this part = elimina este componente
Find and Jump to ... = Encontrar y saltar a...
Please type the prefix, such as U1, R1, C1 = Por favor escribe el prefijo, como U1, R1, C1
Zoom as 1:1, you can print it and then create artwork for etching the PCB. = Zoom está a 1:1, puedes imprimir y crear detalles para el grabado del la PCB
Exporting your works! = ¡Exporta tus trabajos!
Guests can't import a file. Please login! = Invitados no pueden importar archivos, ¡por favor accede como usuario!
Please create a project before you import a file! = ¡Por favor crea un proyecto antes de importar un archivo!
Import your LTspice file! = ¡Importa tu archivo LTspice!
Open LTspice file =
Please make sure the selected LTspice file is a file saved in LTspice V and above. =
Saved successfully! = ¡Guardado correcto!
Save failed! =
Can not place parts into this document. = No se puede colocar componentes en este documento
User Package = Paquete del usuario
System Package = Paquete del sistema
File error = Error del archivo
Please save your file first! = Por favor, ¡guardar el archivo primero!
Email address is too short! = ¡La dirección de correo es demasiado corta!
You have not selected a file to upload. = No hay ningún archivo seleccionado para subir.
Update = Actualizar
No changes, the PCB already matches the schematic! =
Only public files can be shared = Solo los archivos públicos se pueden compartir
Conversion to PCB has failed! = ¡La conversión a PCB ha fallado!
Your username is too short! = ¡El nombre de usuario es demasiado corto!
Your password is too short, it must be more than 6 characters! = ¡La contraseña es demasiado corta, debe contener al menos 6 carácteres!
Conflicting shortcut =
There is an empty PCB file. Please first run Convert Schematic to PCB... from the schematic = Hay un archivo PCB vacío. Por favor, ejecuta el Convertidor Proyecto a PCB... desde el Esquemático
This file has been modified, are you sure you want to run this simulation before saving it first? = El archivo ha sido modificado, estás seguro que quieres ejecutar la simulación? ¿Quizás prefieres guardar primero?
Please enter the Maximum Timestep! = ¡Por favor, introduce el Tiempo de Paso Máximo!
Please enter the Stop Time! = ¡Por favor, introduce el tiempo de Stop!
All of these fields are needed. = Todos estos campos son necesarios.
Either your spice netlist is too big or the server is busy. Please try again later. = Puede que tu netlist spice sea demasiado grande o el servidor esté ocupado. Por favor, intentalo más tarde.
Your spice netlist is too big! Try breaking your circuit into smaller simulatable blocks. = Tu netlist spice es demasiado grande! Intenta desglosar tu circuito en bloques simulables más pequeños.
Too many users in simulation. Please try again later! = Hay demasiados usuarios en simulación. Por favor, intentalo más tarde.
Due to limited server resources, please wait 10 seconds for the interval in every time simulation. =
Your circuit is too complex, we have not enough CPU resource to support this simulation, please reduce your circuit as small as you can. =
Simulation is queuing, try again after 30s. =
Timeout =
Demo accounts don't support simulation, please login first =
Please login first =
The schematic is showing errors, please check the simulation report carefully! = El esquemático muestra errores, por favor comprueba el informe de simulación detenidamente.
Simulation too long, maybe your schematic is too complex. = La simulación es demasiado larga, quizás tu Esquemático es demasiado complejo.
Non-simulated file =
This file can only be opened in standard mode. To open it, please switch to standard mode. =
Load your preferences success! = ¡Se han cargado tus preferencias correctamente!
Save your preferences success! = ¡Se han guardado tus preferencias correctamente!
Update subckt ok! = ¡Actualización de subckt correcta!
Clone your file = Clonar tu archivo
Please type a new file name = Por favor escribe el numbre del nuevo archivo
Create file failure! = ¡Fallo al crear el archivo!
Schematics and PCBs can't be imported under My Libs folder, please choose a different folder =
Libraries to be imported under My Libs folder = Las librerías que serán importadas bajo la carpeta Mis Librerías
Please choose only the libraries needed = Por favor, elige solo las librerías necesarias
Maximum import is 200 libs at one time! = ¡Como máximo 200 librerías para importar a la vez!
You libraries will be found under the My Libs folder = Puedes encontrar tus librerías en la carpeta Mis Librerías
Add to Library =
No items have been checked! = ¡Ningún objeto ha sido comprobado!
Nothing was found, please create it for yourself = Nada encontrado, por favor crealo tu mismo
Search result = Resultados de la búsqueda
At least 3 characters needed = Se requieren como mínimo 3 carácteres
Add to my Favorite Parts = Añadir a mis Componentes Favoritos
Added it OK. Please find it in your Favorite Parts = Añadido correcto. Por favor busca en tus Componentes Favoritos
Please select its parent node = Por favor selecciona un nodo padre
Libraries can not be exported as active project pdf. = Las librerías no pueden ser exportadas como pdf del proyecto activo.
Error:No GND =
This circuit does not have GND. Please select GND from the circuit tool to add to the circuit. =
Current circuit doesn't has Voltage Resource or Current Resource symbol, please place it first at left side EElib or Spice Library. =
Probe can not connect with ground(GND)! =
Spice symbols's properties can't be empty. =
Error:No Spice Symbol =
Simulation limit =
There is a multimeter in the circuit that needs to be simulated using the emulation command .tran or .op =
An oscilloscope exists in the circuit and needs to be simulated using the simulation command .tran =
There are components in this circuit that do not have a simulation model. Please use the base library component of the simulation mode for simulation. =
Circuit does not have a probe =
Make sure your pin numbers are even numbers = Asegurate que la numeración de los pines siguen siendo numeros
Duplicate Components Prefix =
All components are hidden successfully! =
All ratlines are hidden successfully! =
Hidden the ratline of net {netName} successfully! =
Duplicate Component Prefix =
{0} exist =
There are some invalid packages, are you sure? = Hay algunos paquetes invalidos, ¿estás seguro?
Invalid Characters, library only allows [0-9a-zA-Z-_]
Annotation success = Numeración completada
If you accept this annotation operation, please save your files. If not, close your files without saving. = Si aceptas esta operación de numeración, por favor guarda tus archivos. Si no, cierra tus archivos sin guardar.
This file can't be saved under libs project. Please choose other project or create a new project =
Your file is unsaved. = Tu archivo no ha sido guardado.
You can close the editor now. Have a good day! = ¡Puedes cerrar el editor ahora y pasa un buen día!
Successfully logged out = Cierre de sesión correcto
You have at least one unsaved file open. Please save it or close it. =
Please select a reference point =
Please save your file before this operation =
Please open a PCB document =
Please save your file before '{0}'. =
Please try again after saving this file. = Vuelve a intentarlo tras guardar el archivo.
This text can not be empty! =
Export to Altium fail, please try again or contact us. =
Connecting to server = Conectando con el servidor
Please login before asking for help = Por favor accede como usuario antes de realizalizar una consulta de ayuda
This file has been modified, please save it first! = Este archivo ha sido modificado, por favor guardalo primero.
Remove this param = Eliminar este parámetro
You cannot drag a part to the canvas, please click the part and move the cursor to the canvas and then right-click to place. =
Undo/Redo temporary error =
We are sorry but there is an unpredictable error in the undo/redo process. This problem will be fixed soon but in the meanwhile it is safe to continue working on your design. =
The schematic has duplicate prefixes of the components, please make them unique. You can check them using the Design Manager. =
Found duplicated prefix components, can not Import Changes, please modify the duplicated prefix or delete related component. =
Please click the below help button to find out how to fix this problem. =
Please create a board outline! Click the help button to find out how to create a board outline. =
Can not fetch files from server, please check your network and try again =
Please open a schematic first! =
Can not find the schematic of this PCB =
invalid points! =
This file does not support this operation. =
Net Name Conflict =
Net name =
{0} are in the same wire, please remove others and just keep one. =
This field can't be removed! =
Annular ring of the pad/via is too small =
The size of the hole cannot exceed the size of the pad =
Are you sure you want to create a multi-sheet designs? =
Are you sure you want to create a {0}multi-sheet designs{1}? =
Please build the copper area! Click the help button to find out how to build the copper area. =
Suggest to set a package for this component first! =
Please select an opened document first. =
Some files failed to load. Please reload the page. =

#UI Intro
Skip = Saltar
« Back =
Next » =
Done =
This is the user management menu. =
This is the toolbar. =
This is the navigation list. Under here you can find projects, files, parts and libraries. =
Show or hide the toolbar to the top of the window here. =
Show, resize or hide the left sidebar to the left of the window here. =
Show or hide the right sidebar to the right of the window here. =

#Standard libs
Passive Components = Componentes pasivos
Power Supply = Fuente de alimentación
Diodes = Diodos
Regulator = Regulador
Transistor = Transistor
Transformers = Tranformadores
Gates = Puertas
Vacuum Tubes = Tubos de vacío
Switch = Interruptor
Relay = Relé
Capacitor(US) = Condensador (US)
Capacitor(EU) = Condensador (EU)
Capacitor(EU)2 = Condensador 2 (EU)
Electrolytic Capacitor(US) = Condensador Electrolítico (US)
Electrolytic Capacitor(EU) = Condensador Electrolítico (EU)
Electrolytic Capacitor(US)2 = Condensador Electrolítico 2 (US)
Electrolytic Capacitor(EU)2 = Condensador Electrolítico 2 (EU)
Inductor(US) =
Inductor(EU) =
Potentiometer_US =
Potentiometer_EU/IEC =
Potentiometer_3D =
Resistor(US) = Resistencia (US)
Resistor(EU) = Resistencia (EU)
Resistor 45 Deg(US) = Resistencia 45 grados (US)
Resistor 45 Deg(EU) = Resistencia 45 grados (EU)
Variable Capacitor(US) = Condensador Variable (US)
Variable Capacitor(EU) = Condensador Variable (EU)
Variable Resistor(US) = Resistencia Variable (US)
Variable Resistor(EU) = Resistencia Variable (EU)
Variable Inductor(US) = Inductor Variable (US)
Variable Inductor(EU) = Inductor Variable (EU)
Varistor =
Inductor2(US) =
Inductor2(EU) =
Battery = Batería
Voltage Source = Fuente de tensión
Current Source = Fuente de corriente
CCCS(Current Controlled Current Source) = CCCS (Fuente de corriente controlada por corriente)
CCCS2(Current Controlled Current Source) = CCCS2 (Fuente de corriente controlada por corriente)
VCCS(Voltage Controlled Current Source) = VCCS (Fuente de corriente controlada por tensión)
VCVS(Voltage Controlled Voltage Source) = VCVS (Fuente de tensión controlada por tensión)
CCVS(Current Controlled Voltage Source) = CCVS (Fuente de tensión controlada por corriente)
CCVS2(Current Controlled Voltage Source) = CCVS2 (Fuente de tensión controlada por corriente)

BV(Behavioral Voltage Sources) =
BI(Behavioral Voltage Sources) =
Epoly(Non-linear Voltage Source) = Epoly(Fuente de tensión no lineal)
Gpoly(Non-linear Current Source) = Gpoly(Fuente de corriente no lineal)

Diode = Diodo
LED =
LED_3D =
Schottky Diode = Diodo Schottky
Varactor Diode = Diodo Varactor
Zener =
Unidirectional TVS Diode = Diodo TVS Unidireccional
Bidirectional TVS Diode = Diodo TVS Bidireccional
Diac =
Bridge = Puente
78XX =
79XX =
LM317 =
LM337 =
TL431 =
BJT(NPN) =
BJT(PNP) =
MOSFET(Nch) =
MOSFET(Nch) Depletion Four-pins =
MOSFET(Nch) Enhancement =
MOSFET(Nch) Enhancement Four-pins =
MOSFET(Pch) =
MOSFET(Pch) Depletion Four-pins =
MOSFET(Pch) Enhancement =
MOSFET(Pch) Enhancement Four-pins =
JFET(Nch) =
JFET(Pch) =
Darlington NPN =
Darlington PNP =
MESFET(Nch) =
MESFET(Pch) =

IGBT =
SCR =
Triac =
Transform(US) = Transformador (US)
Transform(EU) = Transformador (EU)
Transfrom(NEUTRAL-CTR TAP)(US) = Transformador (Neutro - CTR TAP)(US)
Transfrom(NEUTRAL-CTR TAP)(EU) = Transformador (Neutro - CTR TAP)(EU)
Mutual Inductors = Inductores mutuos
Mutual Inductors2 = Inductores mutuos 2
Or Gate = Puert OR
Xor Gate = Puerta XOR
And Gate = Puerta AND
Nor Gate = Puerta NOR
Nand Gate = Puerta NAND
Not Gate = Puerta NOT
Xnor Gate = Puerta XNOR
Tube Diode = Tubo Diodo
Tube Triode = Tubo Triodo
Tube Tetrode = Tubo Treode
Tube Pentode = Tubo Péntodo
Voltage Controlled Switch = Interruptor controlado por voltaje
Current Controlled Switch = Interruptor controlado por corriente
SPST ON =
SPST OFF =
Fuse = Fusible
555 =
555(Style2) = 555(Estilo 2)
Speaker = Altavoz
XTAL = XTAL
5pin Operational Amplifier = Amplificador operacional de 5 pines
3pin Operational amplifier = Amplificador operacional de 3 pines
Transmission Line = Línea de Transmisión
Voltmeter = Voltímetro
Ammeter = Amperímetro
LAMP = Bombilla
Opto Transistor =

#Server Message
Need login = Necesario Login
Bad password = Contraseña erronea
We can't find your username or your email, please check it! = No podemos encontrar tu nombre de usuario o tu email, por favor revisalo
Make sure your uploaded file size is less than 3MB! = Asegurate de que el tamaño del archivo a subir es inferior a 3MB
Bad file type = Tipo de archivo incorrecto
Empty file or bad file type, ensure your file is Eagle 6.0+ = Archivo vacío o tipo de archivo incorrecto, asegurate de que el archivo es de Eagle 6.0+
This operation not supported on demo account = Esta operación no está permitida en una cuenta de demostración
Can not share this file under a private project, please set the active project to public! = No puedes compartir este archivo bajo un proyecto público, por favor activa el proyecto como público.
Login Failed Too many attempts. If you forgot your password, please {0}reset your password{1} or send an email to support@easyeda.com =

#Dialog Common Buttons
Common Buttons Setting = Configuración común de los botones
Menu Setting... =
Show/Hide = Mostrar/Ocultar
Move Up = Mover hacia arriba
Move Down = Mover hacia abajo
Reset All = Restablecer Todo
Zoom = Zoom
Place Pin = Colocar Pin

#System Setting Dialog
System =
Zoom Mode =
Scroll Key =
CTRL + Scroll =
Canvas Coordinate System =
SVG Coordinate =
Cartesian Coordinate =
Open Wizard Dialog for New Schematic =
Default Unit =
Canvas Zoom Effect =
Quality Priority =
Speed Priority =
Rotation Step =
Add Teardrop Automatically =
Assign Net for Free Track/Arc/Circle =
Open Wizard Dialog for New PCB =
Rebuild Plane Automatically =
The Track's Routing Follows Component's Rotation =
Display Pad's Number and Net =
Favorite Track width =
Track Width Setting =


#Dialog Access Control
Permissions = Permisos
Operations = Operación
Access Control = Control de Acceso
Project Access Control =
Reject = Rechazar
Add User = Añadir usuario
Bad email address = Dirección de correo erronea
# error info from backend
Can't find this email address in EasyEDA. Your partner must be an EasyEDA user. =

#Dialog waveForm
Grid Background = Rejilla de fondo
Pane Background = Panel de fondo
WaveForm Config = Configuración visualizador de forma de onda
Export Waveform =


#attr-canvas-grid-style
dot = Punto
line = Línea

#attr-canvas-frame-size
Other = Otro
A4 Portrait = A4 Vertical
A4 Landscape = A4 Horizontal
A3 Portrait = A3 Vertical
A3 Landscape = A3 Horizontal
A2 Portrait = A2 Vertical
A2 Landscape = A2 Horizontal
A1 Portrait = A1 Vertical
A1 Landscape = A1 Horizontal
Landscape =
Portrait =

#Stroke Style
solid = sólido
dashed = discontinuas
dotted = punteado

#Solid Region
Solid Region =
Type =
type =

#Dialog Libs Management
Report error =
Please give us some information to help us find the problem. =
Cannot place parts into this document: Schematic Symbols can only be placed into a Schematic; PCB Footprints can only be placed into a PCB. =
Save it as a favorite part =
Only logged-in users can save this component as a Favorite Part but guest (Anonymous) users can place this component into their design directly. Would you like to place this component now? =

#Others
Find libs = Encontrar librerías
My Projects = Mis Proyectos
My Parts = Mis Componentes
My Modules =
Assembly LCSC Components =
Modules =
SCH Module =
PCB Module =
System IC = Sistema IC
LCSC (Official) =
LCSC Electronics =
Simple Mode =
Expand Mode =
Help Verify =
Favorite Parts = Componentes Favoritos
Shared With Me = Compartir conmigo
Preview = Previsualizar
Preview Window =
System Default =
User Defined =
Theme =
Theme Setting =
Close = Clonar
Open = Abrir
Toggle toolbar = Activar/desactivar barra de herramientas
Toggle left bar = Activar/desactivar barra izquierda
Toggle right bar = Activar/desactivar barra derecha
Reload = Recargar
Mouse-X =
Mouse-Y =
Mouse-DX =
Mouse-DY =
Bus entry x1 =
Bus entry x2 =
Bus entry y1 =
Bus entry y2 =
Yes = Sí
No = No
OK = OK
Confirm =
Continue =
Cancel = Cancelar
Update = Actualizar
Bus entry = Entrada Bus
Filter = Filtro
Check = Comprobar
Copy the contents of this box into a text editor, then save the file. Paste the edited text back into this box and click Apply to update the display. = Copiar los contenidos de esta caja en el editor de texto, después guarda el archivo. Pega el texto editado de vuelta en esta caja y haz clic en Aplicar para actualizar el display.
Copy the contents of this box into a text editor, then save the file with a .svg extension. You can edit it in Inkscape or open it in your browser. = Copiar los contenidos de esta caja en el editor de texto, después guarda el archivo con la extensión .svg. Puedes editarlo en Inkscape o abrirlo en tu buscador.
Content is too big to show, you can download it directly. =
SVG format = Formato SVG
SVG File = Archivo SVG
Description should be no more than 250 letters = La descripcion no puede superar las 250 letras
The file save operation has timed out. Try again and check your Internet connection. = La operación de guardado del archivo ha sobrepasado el tiempo máximo. Intentalo de nuevo y revisa tu conexión a Internet.
Export Netlist = Exportar Netlist
Notifications =
Please select txt or json files. =
Failed to read file [{file}]
[{file}] is not a valid json file
Invalid parameters! =
Download =
Start =
You have unsaved files, are you sure you want to log out without saving the files? =
Please use the web version to run this function. =
Please save this file to you project! =
Nothing changed =
Delete Node =
This layer is invisible. =
When the solid region is Board Cutout, please set the layer to Multi-Layer. =
You should not try to assign a net to a Board Cutout solid region. =
Net Length =
You can place a Pin in the schematic, but don't forget to group all of the Pins to a schematic component. Please click the help button to find out how to group them. If you just want to mark the wire, please use NetPort or NetLabel. =
Please input the modification =
The content must be between {0} and {1} characters =

Coming soon = Muy pronto
No tool = Sin herramienta
Help us translate into your language = Ayúdanos a traducir a tu idioma
Pad = Pad
Via/Hole =
PCB Layers = Capas PCB
Order PCB = Ordenar PCB
Share = Compartir
Free = Libre
Small = Pequeño
Medium = Mediano
Big = Grande


Embed = Incrustar
HTML = HTML
URL = URL
BBCode = Código BB
PNG = PNG
Exporting as = Exportar como
Exporting as image = Exportar como imagen
Exporting as {0}SVG{1} file. =
Exporting as pdf is recommended: pdf gives good quality printed output and a small file size. = Exportar como PDF recomendado: PDF da gran calidad de impresión y el archivo tiene un tamaño pequeño.
Generate PCB Fabrication File(Gerber) =
PenWidth-Increase =

#Generate Gerber
Generate Gerber =
Gerber View =
Dimensions(Estimated) =
PCB Qty =
Copper Weight =
PCB Price =
Estimated Delivery Time =

HASL(with lead) =
LeadFree HASL-RoHS =
ENIG-RoHS =
Would you like to do Design Rule Checking (DRC) before generating the Gerber files? =
Yes, Check DRC =
No, Generate Gerber =
This PCB has uncompleted connection(s), do you want to check the connection(s)? =
Yes, Check Connection(s) =
It will then redirect to the web site of a third-party JLCPCB with which we cooperate. Are you ready? =
Failed to submit your order, please contact us via support@easyeda.com for help. =
Failed to submit your order, please contact us via QQ 800821856. =
Order data generated finish, please click OK button and continue. =
[generateGerber]
Layers = Capas
[/generateGerber]

[version]
Switch = Interruptor
[/version]


Export your file, then print it yourself. = Exporta tu archivo e imprimelo tu mismo.
Trace width is too small = El tamaño del trazo es demasiado pequeño
Share = Compartir

Images Property = Atributos de Imagen
Connect Pad to Pad = Conexión de Pad a Pad
Copper Area = Área de Cobre
Dimension = Dimensión


Please check that you have used Wire and not Line to connect electrical elements. =
PCB Fabrication Prices & capabilities =
Flip all texts on bottom layer =
Create New Document =
General Package =
General Packages =
favorite Package =
Board Cutout =
Surface Mount =
JLCPCB Part Class =
base =
expand =
recommend =
Basic Part =
Extended Part =
Recommended Part =
smtWeld =
thtWeld =
manualWeld =
furnaceWeld =
Multi-Layer =
Markdown Syntax =
Markdown supported =
Read only =
Read/Write =
More Libraries... =
Decompress failed! =
Load failed! =
Loading =
No Result =

#Dialog Place Pin in schematic warning
Place Pin in schematic warning =
You can place a Pin in schematic, but don't forget to group all of the Pins to a schematic component, please click the help button to find out how to group them. If you just want to mark the wire, please use NetPort or NetLabel. =
I know. Do not show this again. =

#Extensions Setting
Extensions Setting =
Remove =
Disable =
Enable =
(Disabled) =
(Enabled) =
Load Extension =
Enable or disable will be applied after reload page =
Your browser cannot run this function. =
Your browser mode does not support indexedDB. Some features may not work properly. Are you using Private Browsing Mode? =
Extension Files =
Extension ID =
Select Files =

#Scripts
Script =
Scripts =
Script Content =
Load from js file =
UTF-8 encoded js file =
Description =
description =
Not a *.js file =
Failed to read file =
System scripts cannot be modified =
Create Subfolder =
Create Script =
Install Script =
Install =
Are you sure you want to remove this script? =
Folder Name =
Rename =
Please select a script =
Failed to load script =
Run Script =
Load Script =
Title is required =
Script content is required =
System Scripts =
User Scripts =
You can right click on the tree nodes. =

#PCB photoView toolbar
Top Side =
Bottom Side =
With Silk Layer =
No Silk Layer =
Photo View =

#check update
Check Update =
EasyEDA Editor {ver} is released. Would you like to switch to the new version now? =
LCEDA Editor {ver} is released. Would you like to switch to the new version now? =
Switch to New Version =
Next Time =

#download project dialog
Generating download link... =
Download project now =

#Import DXF
Import DXF =
Apply Unit =
Convert circle to HOLE on BoardOutLine layer =
No shapes found =
Fail to load the file =
Please select a DXF file. =
This feature only works for PCB document. =
Select a DXF file =

#Export DXF
Export DXF =
Plated-Through-Hole Pads =
Non-Plated-Through-Hole Pads =
Silkscreen =
Surface Pad =

#Data Sync
Data Sync =
Data Conflicts =
Project or Document =
Cloud-Side =
Local-Side =
Decision =
Modified =
Deleted =
As Cloud =
As Local =
Skip = Saltar
Data sync completed =

#Team
Team =
Teams =
Switching team =
Switch team failed =
Load team info fail! =
Load team info fail! Please reload. =
My Teams =
Create Team =

#Dialog Footprint Manager
Footprint Manager =
Open Footprint Manager =
Schematic Components =
Edit Pin Map Information =
Package Categories =
Components List =
Personal =
Component PIN information =
Footprint PAD information =
Footprint Categories =
Pad Number =
Search Footprint =
Filter by keyword =
System Libs =

#dialog global delete
Drawings =
Netlabel and netFlag =
Texts =
Wires =
Board outlines =
Footprints =
Footprint =
Tracks =

#dialog board outline settings
Current Size =
Paramenters =
Start X: =
Start Y: =
Round Rectangular =
radius =
only number is allowed! =
please input valid value of width! =
please input valid value of height! =
please input valid value of radius! =

#cross probe
The object you selected was not found in other documents. =
No valid object for cross probe selected. =
Can not probe. Refreshing the window may get it to work. =
You need to login for this function to work. =

#About Dialog
An Easier EDA Experience =
Version =
BuiltDate =

#Auto Router Dialog
Auto Router Config =
General Options =
All Layers =
Configure =
Sorry, your web browser does not support this feature. Please run a modern browser. =
Please make sure all objects with net are inside the board outline! =
Cannot start again before previous activity is stopped =
Please select a net =
TrackWidth cannot be empty =
Clearance cannot be empty =
Router is time out. =
Server is busy, please try again later. =
Due to the limitation of {0}router server{1} resources, multiple routers executing concurrently are not supported, please try again later or do it manually :-) =
Track Width is invalid =
General Clearance is invalid =
SMD Clearance is invalid =
Diameter is invalid =
Drill Diameter is invalid =
Track width cannot be less than Design Rule Checking (DRC) setting value. =
General Clearance cannot be less than Design Rule Checking (DRC) setting value. =
SMD Clearance cannot be less than Design Rule Checking (DRC) setting value. =
Hole size cannot be less than Design Rule Checking (DRC) setting value. =
Design Rule's via diameter must be larger than via drill diameter =
Clearance cannot be less than Design Rule Checking (DRC) setting value. =
Not a valid PCB, please check it again =
Previous connection must be closed =
Network error. Please try again. =
Router error. =
Invalid PCB. =
General Clearance =
SMD Clearance =
#Ripup Nets
Skip Routed Nets =
Remove Existing Tracks =
Real-time Display =
Router Layers =
Via =
Special =
Special Nets =
Skip Nets =
Router Server =
Local =
Cloud =
Available =
Unavailable =
Checking =
Install Local Auto Router =
Checking local auto router server... =
Stop Router =
Auto Router is running... =

#Left Sidebar
EELib =
Basic =
Extend =
Design Manager = Manager de diseño
Library =
Spice Library =
Shared =
LCSC =
LCSC Parts =
Supply Flag =
US =
EU/IEC =
US Style =
Resistor =
Capacitor =
Inductor =
Switch/Key =
EU/IEC Style =
CN =
Connector =
Switch/Relay =
JLCPCB =
Recycle Bin =

# Protractor
Font Height =
Precision =
Protractor =

#attr-pcbtext-line-width
Only default font family supports to change font width. =
Font is missing! You can confirm the dialog and use default font instead or cancel the dialog then upload your font and do it again. =

#Common
Owner =
License =
Part Pins =
Net Pins =
Net Ratlines =
Add Parameter =
Histories record =
Create Team =
Can't find this footprint on the server, please re-associate it. =
The footprint name associated with the component and the footprint name on the server are inconsistent, please re-associate it. =
The symbol pin number(s) of the component does not match the associated footprint pad number(s), please modify the symbol pin number(s) or re-associate the footprint =
No footprint, please associate the footprint first. =
Can't find the package =
The path is for the project URL identify, it is unique (the identity of the project owned by the user cannot be the same) =
It's with a letter or a number and can contain only numbers, letters, line-through, underscores, and points. It cannot be modified after saving. =
Updating document to new format, please wait......After finishing please save your document with Ctrl + S. =
Open at current project? =
Please select a history to recover. =
Be careful! When you click the "Recover" button, this sheet will be overwritten! =
Recover = Recuperar
There is no PCB under this project, would you like to create one? =
Please make sure that the chose Altium Designer files are saved as ASCII files. =
Export to Altium function is currently in beta: =
1. Please be sure to read the notice before exporting: =
Export Altium notice and disclaimer =
2. Please be sure to check again after export! =
I have read and agree =
Export to Altium =
Please make sure that the chose Eagle files are saved in Eagle v6.0 and above. =
Please make sure that the Kicad files were compressed as the .zip file. =
Open Altium Designer file =
The more information please refer at : =
Please use Gerber file instead of exporting Altium if you are going to do PCB manufacturing. All PCB factories support the Gerber file. Is it ok to Generate the Gerber file? =
Yes, Generate Gerber =
No, Export Altium =
Open Eagle file =
Open Kicad file =
Select file(s) =
Append to current project? =
Append =
Open as new project =
Tip: Press {0}SPACE{1} or {2}R{3} to rotate the placing object or selected object. =
Hotkeys Setting =
I know. Don't show this again. =
Manufacturer Part Number can not be less than 2 characters. =
This prefix was changed to non-subpart format. =
Save as New Project =
Save to Existing Project =
Sheet Setting =
Sheet Size =
Pre =
pre =
Invalid Data =
Others =
You are not authorized to share this project. =
This project is private: if you continue sharing it will be made public. =
Modify file info =
Please input search keyword =
Sort Projects by =
Date Created =
Date Modified =
Title =
Ascending =
Descending =
Pin to Top =
Unpin from Top =
Collapse / Expand =
Expand =
Collapse =
Expand All =
Collapse All =
Your file hasn't been saved, do you want to save it? =
Don't Save =
Library Owner: =
verifyPkg.Value =
State =
Please select! =
Route =
Import successfully: =
Import failed: =
The title length must be between 2~128 characters. =
Path only contain 'a-z、A-Z、- 、 _ 、0-9'! =
Path must begin as 'a-z、A-Z、0-9'! =
The path length must be between 4~128 characters! =
The title length must be between 2~256 characters! =
The title cannot be less than 3 characters! =
Do you want to delete this file? =
Add sub part success =
Please input name and prefix! =
Board outlines are not closed =
Import Altium file fail, the file needs to be an ASCII file encoded in UTF-8. =
The Pins "{0}" are not snapped on the grid point! This part maybe will cause some errors in the schematic. =
Check Pin =
Failed to read {0} =
{0} is invalid =
{0} not found =
Failed to execute script: =
One or more js files not found =
Only ONE {0} file is required =
Extension ID is required =
Extension ID is invalid =
Extension ID is duplicated =
No Result! =
Load Error =
loading =
Failed to load spice data =
Netlist =
Tags =
Pin Information: =
Format incorrect, please check for the extra spaces or commas! =
Round Radius =
Keyword: =
Image = Imagen
Image copied. =
Copy failed. =
Copy success. =
Image Property =
Locked =
Unlock All =
Unlock =
Lock =
Please input pin name and pin number! =
Left-Hand Panel =
Right-Hand Panel =
Update All =
The pin number(s) can't find the same pad number(s) =
Designator =
Replace =
Update failed =
Successfully updated =
Update failed! =
Successfully updated! =
Successfully updated {0} component(s)! =
Change =
Check Footprints =
Network Error! =
Find Similar Objects =
Current Sheet =
All Sheets =
Kind =
Range =
Net Label/Net Flag/Net Port/Voltage Probe =
Bezier/Freehand Draw =
Arc/Pie =
Objects Properties =
Any =
Same =
Different =
Circular =
Expose Copper =
"{0}" font is missing. Please add the font to the font family list. =
Place Component =
Delete Segment =
Angle =
Board Thickness =
Layer Distance =
Silk Screen =
Surface Finish Color =
Colors =
Board Color =
Board Side =
Silk Screen =
Silk Screen Color =
Display =

# Array and Clone
Distribute Array =
Array Type =
Matrix Array =
Circular Array =
Item Rotation =
Location =
Items per Column =
Items per Row =
# Column Spacing
# Row Spacing
Spacing(Degrees) =
Start Degree =
Rotate Item to Match =
Clockwise =
Anti-Clockwise =
Distribute by =
Column =
Row =
Array Clone =
Number of Rows =
Number of Columns =
Number of Copies =
Distribute Range(Degrees) =

# Theme color dialog
BusEntry =
Foreground =
Common Used =
Original Theme =
Theme Setting =
Change the theme colors of your design =
White on Black =
Black on White =
Custom Theme =
Color Setting =
Apply Setting =
Theme Setting... =
Bus Entry = Entrada Bus
Foreground =
Symbol Graphics =
Common Used =
Draw = Dibujar
Sheet = Hoja
The original theme only works for placing the new symbols. =
Selection Highlight =
Net Label / Port =

My Theme =
My Theme Settings =
Apply 'Custom Theme' On =
Creating New Schematic =
Opening Existed Schematic =
Please fill in all parameters! =
Convert to Board Cutout =
Prefix Position =
Name Position =
Center =
Top =
Bottom =
Left =
Right =
Does not support multiple objects to convert to Board Cutout at the same time =
Does not support multiple objects to convert to pad at the same time =
Convert to Board Cutout =
Convert to Pad =
Convert to Component Shape =
Combine to Continuous Track =
Convert to Solid Region =
Substrate =
3D View =
2D View =
Pin Color =
Name Color =
Number Color =
Dot =

[theme]
Sheet =
[/theme]


#history dialog
[history-dlg]
Number = Numero
Editor =
[/history-dlg]
View File History =
Save Time =

Invalid Format =

#Dialog Teardrop
Round Pad / Via =
Rectangle / Oval / Polygon Pad =
Applying Teardrops =
Removing Teardrops =
Waiting =
Progressing... =

No schematic in the project! =

Move Forward =
Move Backward =

#Dialog Panelize
V-CUT =
Stamp Hole =
No Panelize =
Border and Marking =
Create Border =
Border Height =
Border Position =
Create Positioning Holes =
Create Fiducial Marks =
Top and Bottom =
Left and Right =
Stamp Hole Group - Column =
Stamp Hole Group - Row =
The number of rows and columns cannot be set to 1 simultaneously =

#edit path point
[editPathPoints-dlg]
Arc(R) = Arco(R)
Type = Tipo
Action =
add before = agregar antes
add after = agregar después
delete = eliminar
[/editPathPoints-dlg]

#edit polygon point
[editPolygonPoints-dlg]
Action =
add before = agregar antes
add after = agregar después
delete =
[/editPolygonPoints-dlg]
You have unconfirmed edit! =
Invalid edit! =

#Dialog PCB Information
PCB Information... = Información de PCB
Signal Layers = Capas de señales
None Signal Layers =
Pads = Pads
Surface Pads = Pads Superficiales
Plated Through-hole Pads =
None Plated Through-hole Pads =
Holes = Agujeros
Vias = Vías
Length of Tracks =
Copper Areas = Áreas de Cobre

#Differential Pair Routing
Differential Pair Routing =
Differential Pair Rule Setting =
Please input track width =
Please input clearance =
Routing Rules =

#Route Length Tuning
Track Length Tuning... =
Tracks with different net or non-track found in current targets. =
Please select the signal tracks to be tuning. =
The total length exceeds the Design Rule Checking (DRC) constraint, continue ? =
45° Angle =
90° Angle =
DRC Track Length : =
Current Length : =
Additional Length : =
Target Length: =
Current Length: =

can not connect to the server = no se puede conectar con el servidor

#Dialog Copper Area Manager
Copper Area Manager... =Administradoor de Área de Cobre...
Copper Area Manager = Administradoor de Área de Cobre
Order = Orden
Name = Nombre
Layer = Capas
Color = Color
Net =
Move Up = Mover hacia arriba
Move Down = Mover hacia abajo
Apply = Aplicar
Cancel = Cancelar
Copper Area do not allow self-intersection! =
No copper area! = ¡No área de cobre!
#Dialog report error
Datasheet = Hoja de Datos
Verification =
Symbol = Símbolo
Pad Number = Número de Pad
Pad Size = Tamaño de Pad
Remark =
Correct = Correcto
Incorrect = Incorrecto
Submit = Enviar
Tip =
Please select one component =
Location X =
Location Y =
Your current browser version may not support some features. Please use the latest version of Chrome or Firefox, or try the desktop client. =
EasyEDA Client = Cliente EasyEDA
LCEDA Client = Cliente LCEDA
Chrome = Chrome
FireFox = FireFox
New Version =
Switch Version =
Members = Miembros
Update Time =
Editor = Editor
Current Version: =
Select a version to switch =
3D Model = Modelo 3D
Board Side =
Display =
Copper = Cobre
Create New Version =
Create new version success! =
Version Management =
Switch success! =
Please close current version's documents first! =
Creator =
Create Time =
Fail to connect to server! Please check your internet connection status and try again! =
Spice Number =
Create = Crear
3D Outline =
Cannot create the slot hole via the board outline, please use the following methods: =
Use the solid region and set its type as Board Cutout =
Select a Track/Arc, right-click to use the "Convert to Board Cutout" =
Select all the closed Tracks/Arcs, right-click to use the "Convert to Board Cutout" =
The more information please refer at =
Save "{0}" success! =
Save "{0}" failed! =
Invalid Size =
Processing =
Invalid Size =
NetFlag GND =
NetFlag VCC =
NetFlag +5v =
No Useful Data! =
SVG Preview =
Prefix contains not supported charater(s) ! =
Name contains not supported charater(s) ! =
Create Grid Path =
Please Input Name =
Building Copper Area =
Processing = Procesando
Opening File = Abriendo Archivo
Update from Library = Actualizar desde Librería
Update Footprint = Actualizar Huella
Find footprint(s) have been updated, do you want to update? =
3D File: =
Model List =
Are you sure merge net {0} and net {1}? =
Display Footprint =
Display Footprint Name While Placing Component =
Annotate Prefix Automatically After Placing Component =
Program Error, Please Contact Technical Support! =
Search Engine =
Keyword to Filter =
Normal Mode =
Expand Mode =
3D Model Manager =
3D Model Preview =
3D Model =
3DModel =
Document = Documento

[pcblayer]
3DModel =
Document = Documento
[/pcblayer]

Adjustment =
View Larger Image =
Previous = Anterior
Previous Image = Imagen Anterior
Next Image = Imagen Siguiente
Notice: For reference only, please refer to the real product =
It's under designing, please wait. =
The width of track/arc/circle cannot be less than 0.1mil! =
Clone success ! = ¡Clonación exitosa!
Footprint Naming Reference =
3D Model Manager = Administrador de Modelo 3D
Will jump to the Lichuang open source hardware platform (OSHWHub.com) to improve the information and share. Whether to continue? =
Will jump to the EasyEDA open source hardware platform (OSHWLab.com) to improve the information and share. Whether to continue? =
The project content page will open. After adding a description and setting the project to public, you can click the share button to get the share link. =
This project is not public, can not view homepage! =

[grid]
None = Ninguno
[/grid]

#lib verify and mounted
This component is verified = Este componente está verificado
This component is unmounted = Este componente está desmontado

#find component
Find Next = Encontrar Próximo
Object not found = Objeto no encontrado

#offset Elements
Offset X = Desplazamiento X
Offset Y = Desplazamiento Y
Offset = Desplazamiento
Absolute Offset = Desplazamiento Absoluto
Relative Offset = Desplazamiento Relativo
Absolute Offset... = Desplazamiento Absoluto...
Relative Offset... = Desplazamiento Relativo...
Reference Point X = Punto de Referencia X
Reference Point Y = Punto de Referencia Y

# Inner Plane layer
Rebuild Plane =
PlaneZone Properties =
Change to a plane layer is not allowed during track routing. =
#pcblib rect
Fill =
Fill Type =
[PlaneZone]
Solid =
[/PlaneZone]

Solid Region do not allow self-intersection! =

The prefix or name or text too far away from the footprint, if you don't want it to show up please make it hidden. =
The prefixes are not allowed to repeat! =
Save failed! The origin of the canvas is not in the graphics! Whether to set the origin automatically? =
The origin of the canvas has been set in the graphics now, you can save again. =
Backup Project =
Open Project Directory =

{0} items updated =

The current file {0} has an updated version. Do you want to overwrite it? If you want to open the latest version, please close the current file and reopen it. =
Yes, Overwrite It =
No, Keep It =

Download Client = Descargar cliente

Search tutorial、open source projects etc. =

Go to LCSC and search for =
Go to LCSC =

Hide Ratline Layer and Keep the Component Prefix When Paste Objects =

ALL.layer =
Copper.layer =
Non-Copper.layer =
Other.layer =

Please enter at least 2 characters! =
View Datasheet =
View Datasheet... =

The corresponding package or network could not be found in the currently open PCB document =
delete fail =

[crashRecovery]
Libraries = Librerias
[/crashRecovery]
Canvas origin anomaly! =

Component's Name = Nombre del componente
Component's Prefix = Nombre del prefijo
Component's Footprint =

[findlib]
Clear = Limpiar
Apply Filters = Aplicar filtros
Result = Resultado
Place = Ubicar
Prev = Anterior
Next = Siguiente
Total {count} Count =
About = Acerca de
Items = Elementos
[/findlib]

Object = Objeto
Layers and Objects = Capas y Objetos
All = Todos

Add custom = Agregar personalizado

Connections =
Attempted: =
Completed: = Completado:
Failed: =
Total Vias: =

Please confirm moving option =
Only this pad = Solo este pad
For this component = Para este componente
View Owner = Ver propietario
View Detail = Ver detalle


# place batch vias
Place Vias = Colocar Vías
Placing Vias =
Removing Vias =
Batch Vias for Copper =
Add/Remove Vias =
Diameter = Diámetro
Drill Diameter = Diámetro taladro
Column Spacing =
Row Spacing =
Multiple vias have been placed, do you want to rebuild the copper area? =
Remove vias finish, do you want to rebuild the copper area? =
The width of track/arc/circle cannot be less than 0.051mm/2mil/0.002inch! =
Save fail! Please try again! =
Please select a copper outline =
Can't find copper area at other layers, please add the copper area with the same net at other layer first. =

Add favorite success! =
Remove favorite success! =
Remove favorite failed! =
Whether if remove favorite? =
Split by ';' for multi tags =

This size is the determined size! =
The associated pad has been locked =
Split by space or , for multi tags =

Rotation X = Rotación en X
Rotation Y = Rotación en Y
Rotation Z = Rotación en Z

Some fields are filled invalid data =
start time should be earlier than stop time =
Number of points should be less than 100 in octave variation =
Start frequency should be less than stop frequency. The suffix meg stands for Mega,m stands for milli =
Get historical records fail! =
This 3D model didn't create the outlines successfully, please import it again or contact with us. =
There is No Tag! =
Assign successful! = ¡Asignación exitosa!
Found footprint's pad number doesn't match the schematic component's pin number, please correct the pad number and try again! =
Update Property = Actualizar Propiedad
Please fill in at least 5 words. = Por favor llenar con al menos 5 letras.
Mouse hovering over the track to highlight the entire network =
Net Highlighting While Cursor Hover the Track =
When circle set as "Yes", the Pin length must be more than 6 =
Hi, I found a problem of your library, this library seems incorrect.\ntitle:{title}\nType:{type}\nlink:{link}\n{content}\nThank you! =

Logout fail! Please try again! =
Logout success! We look forward you to use LCEDA again! =
Logout success! We look forward you to use EasyEDA again! =
Click to Preview 3D =
[logoutDialog]
Logout = Desconectar
[/logoutDialog]

[findlibTag]
All = Todos
[/findlibTag]

Export Pick and Place File =
Mirror the bottom component's X coordinate (JLCPCB doesn't need) =
Work Space =
Include panelized components' coordinates =
Personal Workspace =
Work Space - {name} =
Work Space - Personal =
Cloning =

Project Owner =
Clone Project = Clonar proyecto
Homepage = Pagina inicio
Apply for Education Edition =
Load Organization failed =
Joined =
Favorite = Favorito
This operation will unfavorite this project, do you want to continue? =
View Homepage = Pagina de inicio
Private Project = Proyecto privado
3-7 days = 3-7 días
Close Tab =
Close Other Tabs =
Close All Tabs =
Open in New Window =
Cursor Snap to Component's Origin or Pad Center While Dragging Component =
Undefined =
Input =
Model Unit =
File Unit =
This part contains subparts, please make sure you have checked other subparts before reporting error, do you want to continue? =

[saveAs]
Power =
[/saveAs]

Assign LCSC Part# =
Unexpected error while converting. Perhaps unsupported file type or program bug. =
Found duplicated component IDs, please click "OK" to re-assign component ID automatically, and then save the document and try again. =

#electromagneticSimulation
Electromagnetic Simulation... = Simulación electromagnética...
You will upload Gerber to SuperEM for electromagnetic simulation (only upload Gerber, not including account data), do you want to continue? =
SuperEM is a 3-D full-wave electromagnetic simulation and design platform for high-speed PCB circuits and antennas, which is developed by Faraday Dynamics, Ltd. =
Visit the SuperEM =
SuperEM User Guide =
Upload Gerber to SuperEM successfully, please click "OK" buttun to continue =

Format = Formato
View = Ver
Design = Diseño
Simulation = Simulación
Advanced = Avanzado
Fabrication = Fabricación
Check DRC =
Simulation Setting = Configuración Simulación
BOM =
PCB Fabrication File(Gerber) = Archivo fabricación PCB(Gerber)
Pick and Place File =
Parts Order =
PCB Order =
SIM =
STD =
WaveForm =

Place Module =
Please enter identification letters: =
Only support English letters, up to 5. =

Exist doesn't annotate prefix component(s) in the module, please edit and annotate the unique prefix(s) for component(s) first. =
Opening =

Also update track's net (Only applies to circumstance under which prefix/netlabel changes and no component/wire is added or removed) =

# desktop client error feedback
Cannot open online documents on Project Offline mode. = No se puede abrir documentos en línea en modo Proyecto fuera de línea

Please select a project = Porfavor selecciona un proyecto
Opened Projects = Proyectos abiertos
Open Project = Abrir proyecto
Close Project = Cerrar Proyecto
Open All Projects = Abrir todos los Proyectos
Close All Projects = Cerrar todos los Proyectos
Select Owner = Seleccionar Propietario
Select Folder = Seleccionar Carpeta
Select Owner or Folder =
Select Project = Seleccionar Proyecto
Folder = Carpeta
New Folder = Nueva Carpeta
New Sub Folder = Nueva Sub-carpeta
Delete Folder = Eliminar Carpeta
Move Project = Mover Proyecto
Move Folder = Mover Carpeta
# Rename Folder = # Renombrar Carpeta
Please input the folder name = Por favor ingresar el nombre de la carpeta
Invalid folder name = Nombre de carpeta inválido
Are you sure to delete this folder? =
Create new folder successfully =
Failed to create new folder =
Delete folder successfully =
Failed to delete folder =
Rename folder successfully =
Failed to rename folder =
Move folder successfully =
Failed to move folder =
Move project successfully =
Failed to move project =
The folder depth must not exceed {0} levels =
Failed to add project to folder =

Doesn't support JLCPCB SMT Service =
{0} for JLCPCB SMT Service =

Reset failed! There are duplicate component prefixes in the current schematic: =
Reset failed! There are duplicate component prefixes in the current PCB: =
Please modify the component prefixes first to ensure that the component prefix is unique. =

LCEDA(Standard) - A Simple and Powerful Electronic Circuit Design Tool = LCEDA(Estándar) - Una Simple y Poderosa Herramienta de Diseño De Circuitos Electrónicos
EasyEDA(Standard) - A Simple and Powerful Electronic Circuit Design Tool = EasyEDA(Estándar) - Una Simple y Poderosa Herramienta de Diseño De Circuitos Electrónicos

#Dialog for Package Custom Data
Please input the data title =
Data title duplicated =
Cannot be more than {0} characters! =
Only latin alphabets, digits, underscore(_) and hyphen(-) are allowed. =
Invalid value of item {0} =
Update DFM =
Custom DFM Data =
Saved custom data successfully! =
Save custom data failed! =
Will replace the graphics and custom data of current document, after imported please adjust the 3D model. Continue or not? =
Open footprint "Custom Data" dialog =

# Create lead shape
Create Lead Shape =
Base on Pad Center =
Base on Canvas Origin =
Lead shape =
Footprint Type =
From pad shape =
Lead length =
Lead width =
Lead diameter =
Scaling ratio =
Leads creating direction =
Auto = Auto
Horizontal = Horizontal
Vertical = Vertical
Canvas origin to lead edge =
Canvas origin to body edge =
Lead soldering length =
Lead soldering part diameter =
Component shape object doesn't overlap lead shape object, please check carefully. =
The solder mask expansion of pads ({0},{1}) has a small clearance(less than 0.08mm), it will cause the soldering too short, please modify. =
The paste mask expansion or custom paste mask layer objects of pads ({0},{1}) has a small clearance(less than 0.15mm), it will cause the stencil to create fail, please modify. =
System footprint must have pad number 1 or A1, please modify the pad number. =
System footprint doesn't allow two or more pad numbers are 1 or A1, please modify the pad number. =
Document layer has circle object, but jlcPara's polarity is 0, please check the Custom Data. =
There are exist repeat pad numbers: {padNumber}, please check, if it is correct please ignore this. =
Can't find the circle at the component marking layer, or this circle doesn't at the same quadrant with the 1st pad, please check whether it is correct. =

ROUND = CIRCULAR
RECTANGLE = RECTANGULO
OCTAGONAL = OCTAGONAL
Upper left = Arriba izquierda
Lower left = Abajo izquierda
Center of Pads = Centro de los Pads
First Pin = Primer Pin
Package Name = Nombre del paquete
Pins Number = Número de Pines
Rows Of Pin = Filas del Pin
Columns Of Pin = Columnas del Pin
Polarity = Polaridad
Pad Shape = Forma del Pad
Body Diameter = Diámetro del cuerpo
Lead Span =
Lead Vertical Span =
Body Length = Longitud del Cuerpo
Body Height = Altura del Cuerpo
Pin Diameter = Diámetro del Pin
Pin Length = Ancho del Pin
Pin Height = Alto del Pin
Pin Solid Width =
Pin Solid Height =
Pin Spacing =
Pin Horizontal Spacing = Espacio horizontal del Pin
Pin Vertical Spacing = Espacio vertical del Pin
ThermalPad =
Pad Expansion = Expansión de Pad
Custom PasteMask =
Fabrication Tolerance = Tolerancia de fabricación
Placement Tolerance =
FirstPin Position =
Package Origin =
Expansion Size =
Corner = Esquina
Angle = Ángulo
Fillet =
Chamfer = Chaflán
Update Preview = Actualizar Vista Previa
Number of pins (left and right) = Número de pins (izquierda y derecha)
Number of pins (up and down) = Número de pins (arriba y abajo)
Reference Use Cases =
Package Type = Tipo de Empaquetado
Capacitance = Capacitancia
Resistance = Resistencia
Bidirectional Diode = Diodo bidireccional
Inductance = Inductancia
Crystal Oscillator = Cristal oscilador
Diode = Diodo
LED = LED
Fuse = Fusible
Entity height =
Entity height =
Lead Overhang =
Lead Thickness =
Unknown mistake =
Has ThermalVias =
Polar Capacitance =

Create Component Marking =
Create component marking successfully! =
No elements on component shape layer! =
No elements on lead shape layer! =
No pad of number 1 or A1, please modify the pad number. =
Save failed! Component marking circle is at the axis. Do you want to recreate the component marking? =
If autoroute fail, you can export the autoroute file(DSN) to third-party autorouter tool(Such as: FreeRouting, Konekt Electra, Eremex TopoR etc.), and export the session file(SES) after finished autoroute, and then import to PCB. =
Auto route failed! Found abnormal pad(s) data, please modify the pad width and height: =
Select Properties =
Combine the same parts' prefixes in one row =
Please check at least one item! =
Pins =
Check component latest version when open schematic =
Only show updated components =
Note: When a PCB is Import Changes, the PCB is updated according to the footprint version to which the schematic is bound. =
Doesn't support to import the binary format DXF, please import the ASCII format DXF. =

Find System Similar Footprint =
Found similar footprints at system library, it is recommended to use them first. =
Copy Title =
Check system similar footprint =
Can't find the Similar Footprint =
Search failed! =
No package information! =
Find Parameters =
Find Results =

Bill of material(BOM) uploaded finish, please click "OK" to continue. =
Bill of material(BOM) upload failed! =

All pads =
All holes =
Single layer pads =
Multi-layer pads =
Same X pads =
Same Y pads =
Same Y and clearance pads =
Same X and clearance pads =
Same X and clearance pads' clearance =
Same Y and clearance pads' clearance =
Pad's hole diameter(max) =
Pad's hole diameter(min) =
Pad's hole diameter(aver) =

Try Pro Edition =

Generate Solid Region by Objects Outline =
Generate Polygon Pad by Objects Outline =
Select the objects that cannot be generated =

Please compress schematic and PCB as a zip file and then import it, if you only import the schematic you need to binding with the footprint manually. =
Please compress schematic and PCB in ASCII format as a zip file and then import it, if you only import the schematic you need to binding with the footprint manually. =
Import failed! The imported files were not ASCII format, please save the files as "Advanced Schematic ascii(*.SchDoc)" or"PCB ASCII File(*.PcbDoc)" at Altium Designer first, and then import. =
The PCB text will use the editor new font family, the text maybe will appear a little excursion. =
Because of different file format and element, please check carefully after imported. =
Please make sure the EAGLE file is saved in EAGLE v6.0 and higher version. =
Please compress schematic and PCB as a zip file by KiCad5 and then import it, if you only import the schematic you need to binding with the footprint manually. =
Please make sure the Protel file is exported as ASCII format file. =
Please compress the schematic and corresponding symbols as a zip file and then import it. =

Please save the files as "Advanced Schematic ascii(*.SchDoc)" or"PCB ASCII File(*.PcbDoc)" at Altium Designer first, and then import. =
Tips =
Exists incomplete connection =
Found that the board has incomplete connection, please check the nets and ratlines =
creator =
You are not logged in or the login status is invalid, please login and try again. =
Display Board Cutout =
